# extra entries for the postag database
gewriemel	gewriemel	ZNW:EKV:HET
André	André	ENM:PER:1ST
Beyoncé	Beyoncé	ENM:PER:1ST
Cécile	Cécile	ENM:PER:1ST
Léon	Léon	ENM:PER:1ST
Thérèse	Thérèse	ENM:PER:1ST
Piet	Piet	ENM:PER:1ST
VS	VS	ZNW:MRV:DE_
Claude	Claude	ENM:PER:1ST
Harvard	Harvard	ENM:ORG
Melbourne	Melbourne	ENM:PER:1ST
Pius	Pius	ENM:PER:1ST
Miami	Miami	ENM:LOC:PLC
higgsboson	higgsboson	ZNW:EKV:VRK:HET
higssbosonen	higgsboson	ZNW:MRV:DE_
Oxford	Oxford	ENM:LOC:PLC
Sevilla	Sevilla	ENM:LOC:PLC
Leipzig	Leipzig	ENM:LOC:PLC
V&D	V&D	ZNW:EKV:DE_
spinneruil	spinneruil	ZNW:EKV:DE_
spinneruilen	spinneruil	ZNW:MRV:DE_
Wiske	Wiske	ENM:PER:1ST
COA	COA	ZNW:EKV:HET
OESO	OESO	ZNW:EKV:DE_
Tele2	Tele2	ENM:ORG
Sumatra	Sumatra	ENM:LOC:EIL
Netflix	Netflix	ENM:ORG
Dexia	Dexia	ENM:ORG
Bretagne	Bretagne	ENM:RGN
Bonn	Bonn	ENM:LOC:PLC
Cannes	Cannes	ENM:LOC:PLC
Philadelphia	Philadelphia	ENM:LOC:PLC
Versailles	Versailles	ENM:LOC:PLC
Manhattan	Manhattan	ENM:LOC:PLC
Toronto	Toronto	ENM:LOC:PLC
Vancouver	Vancouver	ENM:LOC:PLC
West-Java	West-Java	ENM:RGN
Batman	Batman	ENM:PER:1ST
Aboutaleb	Aboutaleb	ENM:PER:LST
Paradiso	Paradiso	ENM:RGN
GeenStijl	GeenStijl	ENM:ORG
