# entries to be removed from the postag database
grootste	grootste	ZNW:EKV
grootsten	grootste	ZNW:MRV:DE_
ooglensen	ooglens	ZNW:MRV:DE_
scherpst	scherpst	ZNW:EKV
suikerrijkste	suikerrijkste	ZNW:EKV:DE_
suikerrijksten	suikerrijkste	ZNW:MRV:DE_
aanbedene	aanbidden	WKW:VTD:VRB
aanbedenen	aanbidden	WKW:VTD:MRV:DE_
aaneengehoudene	aaneenhouden	WKW:VTD:VRB
aaneengehoudenen	aaneenhouden	WKW:VTD:MRV:DE_
aaneengeschovene	aaneenschuiven	WKW:VTD:VRB
aaneengeschovenen	aaneenschuiven	WKW:VTD:MRV:DE_
aaneengesmoltene	aaneensmelten	WKW:VTD:VRB
aaneengesmoltenen	aaneensmelten	WKW:VTD:MRV:DE_
aangebedene	aanbidden	WKW:VTD:VRB
aangebedenen	aanbidden	WKW:VTD:MRV:DE_
aangeblazene	aanblazen	WKW:VTD:VRB
aangebodene	aanbieden	WKW:VTD:VRB
aangebodenen	aanbieden	WKW:VTD:MRV:DE_
aangedanen	aandoen	WKW:VTD:MRV:DE_
aangeganen	aangaan	WKW:VTD:MRV:DE_
aangehevene	aanheffen	WKW:VTD:VRB
aangehevenen	aanheffen	WKW:VTD:MRV:DE_
aangehoudene	aanhouden	WKW:VTD:VRB
aangeknepene	aanknijpen	WKW:VTD:VRB
aangeknepenen	aanknijpen	WKW:VTD:MRV:DE_
aangekomene	aankomen	WKW:VTD:VRB
aangekomenen	aankomen	WKW:VTD:MRV:DE_
aangekropene	aankruipen	WKW:VTD:VRB
aangekropenen	aankruipen	WKW:VTD:MRV:DE_
aangenomene	aannemen	WKW:VTD:VRB
aangeprezene	aanprijzen	WKW:VTD:VRB
aangeredene	aanrijden	WKW:VTD:VRB
aangeroepene	aanroepen	WKW:VTD:VRB
aangeschotene	aanschieten	WKW:VTD:VRB
aangeschovenen	aanschuiven	WKW:VTD:MRV:DE_
aangeschrevene	aanschrijven	WKW:VTD:VRB
aangeslagene	aanslaan	WKW:VTD:VRB
aangeslotene	aangeslotene	WKW:VTD:VRB
aangesmetene	aansmijten	WKW:VTD:VRB
aangesmetenen	aansmijten	WKW:VTD:MRV:DE_
aangesnedene	aansnijden	WKW:VTD:VRB
aangesnedenen	aansnijden	WKW:VTD:MRV:DE_
aangespotene	aanspuiten	WKW:VTD:VRB
aangespotenen	aanspuiten	WKW:VTD:MRV:DE_
aangesprokene	aanspreken	WKW:VTD:VRB
aangestane	aanstaan	WKW:VTD:VRB
aangestanen	aanstaan	WKW:VTD:MRV:DE_
aangestevene	aanstijven	WKW:VTD:VRB
aangestevenen	aanstijven	WKW:VTD:MRV:DE_
aangestokene	aansteken	WKW:VTD:VRB
aangestovene	aanstuiven	WKW:VTD:VRB
aangestovenen	aanstuiven	WKW:VTD:MRV:DE_
aangetegene	aantijgen	WKW:VTD:VRB
aangetegenen	aantijgen	WKW:VTD:MRV:DE_
aangetredene	aantreden	WKW:VTD:VRB
aangetredenen	aantreden	WKW:VTD:MRV:DE_
aangetroffenen	aantreffen	WKW:VTD:MRV:DE_
aangetrokkene	aantrekken	WKW:VTD:VRB
aangevallene	aanvallen	WKW:VTD:VRB
aangevangene	aanvangen	WKW:VTD:VRB
aangevezene	aanvijzen	WKW:VTD:VRB
aangevezenen	aanvijzen	WKW:VTD:MRV:DE_
aangevlochtene	aanvlechten	WKW:VTD:VRB
aangevlochtenen	aanvlechten	WKW:VTD:MRV:DE_
aangevochtene	aanvechten	WKW:VTD:VRB
aangevretene	aanvreten	WKW:VTD:VRB
aangevretenen	aanvreten	WKW:VTD:MRV:DE_
aangewezene	aanwijzen	WKW:VTD:VRB
aangeworpenen	aanwerpen	WKW:VTD:MRV:DE_
aangeworvene	aanwerven	WKW:VTD:VRB
aangeworvenen	aanwerven	WKW:VTD:MRV:DE_
aangewrevene	aanwrijven	WKW:VTD:VRB
aangezetene	aanzitten	WKW:VTD:VRB
aangeziene	aanzien	WKW:VTD:VRB
aangezienen	aanzien	WKW:VTD:MRV:DE_
achtergeblevene	achterblijven	WKW:VTD:VRB
achtergegane	achtergaan	WKW:VTD:VRB
achtergeganen	achtergaan	WKW:VTD:MRV:DE_
achtergehangene	achtergehangene	WKW:VTD:VRB
achtergehoudene	achterhouden	WKW:VTD:VRB
achtergelatene	achterlaten	WKW:VTD:VRB
achtergestane	achterstaan	WKW:VTD:VRB
achtergestanen	achterstaan	WKW:VTD:MRV:DE_
achternagedane	achternadoen	WKW:VTD:VRB
achternagedanen	achternadoen	WKW:VTD:MRV:DE_
achternagelopene	achternalopen	WKW:VTD:VRB
achternagelopenen	achternalopen	WKW:VTD:MRV:DE_
achternageredene	achternarijden	WKW:VTD:VRB
achternageredenen	achternarijden	WKW:VTD:MRV:DE_
achternagezetene	achternazitten	WKW:VTD:VRB
achternagezetenen	achternazitten	WKW:VTD:MRV:DE_
achternagezondene	achternazenden	WKW:VTD:VRB
achteromgekekene	achteromkijken	WKW:VTD:VRB
achteromgekekenen	achteromkijken	WKW:VTD:MRV:DE_
achteromgeziene	achteromzien	WKW:VTD:VRB
achteromgezienen	achteromzien	WKW:VTD:MRV:DE_
achterovergeslagene	achteroverslaan	WKW:VTD:VRB
achteruitgegane	achteruitgaan	WKW:VTD:VRB
achteruitgeganen	achteruitgaan	WKW:VTD:MRV:DE_
achteruitgeredene	achteruitrijden	WKW:VTD:VRB
achteruitgeredenen	achteruitrijden	WKW:VTD:MRV:DE_
achteruitgeschovene	achteruitschuiven	WKW:VTD:VRB
achteruitgeschovenen	achteruitschuiven	WKW:VTD:MRV:DE_
achteruitgetrokkene	achteruittrekken	WKW:VTD:VRB
achteruitgetrokkenen	achteruittrekken	WKW:VTD:MRV:DE_
achteruitgevlogene	achteruitvliegen	WKW:VTD:VRB
achteruitgevlogenen	achteruitvliegen	WKW:VTD:MRV:DE_
achteruitgewekene	achteruitwijken	WKW:VTD:VRB
achteruitgewekenen	achteruitwijken	WKW:VTD:MRV:DE_
adergelatene	aderlaten	WKW:VTD:VRB
adergelatenen	aderlaten	WKW:VTD:MRV:DE_
afgebedene	afbidden	WKW:VTD:VRB
afgebedenen	afbidden	WKW:VTD:MRV:DE_
afgebetene	afbijten	WKW:VTD:VRB
afgebodene	afbieden	WKW:VTD:VRB
afgebodenen	afbieden	WKW:VTD:MRV:DE_
afgebondenen	afbinden	WKW:VTD:MRV:DE_
afgebrokene	afbreken	WKW:VTD:VRB
afgedokene	afduiken	WKW:VTD:VRB
afgedokenen	afduiken	WKW:VTD:MRV:DE_
afgedragene	afdragen	WKW:VTD:VRB
afgedronkene	afdrinken	WKW:VTD:VRB
afgegane	afgaan	WKW:VTD:VRB
afgeganen	afgaan	WKW:VTD:MRV:DE_
afgegevene	afgeven	WKW:VTD:VRB
afgegledene	afglijden	WKW:VTD:VRB
afgegotene	afgieten	WKW:VTD:VRB
afgegravene	afgraven	WKW:VTD:VRB
afgegravenen	afgraven	WKW:VTD:MRV:DE_
afgehevene	afheffen	WKW:VTD:VRB
afgehevenen	afheffen	WKW:VTD:MRV:DE_
afgehoudene	afhouden	WKW:VTD:VRB
afgehoudenen	afhouden	WKW:VTD:MRV:DE_
afgehouwene	afhouwen	WKW:VTD:VRB
afgeklommene	afklimmen	WKW:VTD:VRB
afgeklommenen	afklimmen	WKW:VTD:MRV:DE_
afgeklonkene	afklinken	WKW:VTD:VRB
afgeklonkenen	afklinken	WKW:VTD:MRV:DE_
afgeknepenen	afknijpen	WKW:VTD:MRV:DE_
afgelachene	aflachen	WKW:VTD:VRB
afgelachenen	aflachen	WKW:VTD:MRV:DE_
afgelegene	afliggen	WKW:VTD:EKV
afgelogene	afliegen	WKW:VTD:VRB
afgelogenen	afliegen	WKW:VTD:MRV:DE_
afgelopene	aflopen	WKW:VTD:VRB
afgemalene	afmalen	WKW:VTD:VRB
afgemetene	afmeten	WKW:VTD:VRB
afgemolkene	afmelken	WKW:VTD:VRB
afgemolkenen	afmelken	WKW:VTD:MRV:DE_
afgenepene	afnijpen	WKW:VTD:VRB
afgenepenen	afnijpen	WKW:VTD:MRV:DE_
afgenomene	afnemen	WKW:VTD:VRB
afgeredene	afrijden	WKW:VTD:VRB
afgeredenen	afrijden	WKW:VTD:MRV:DE_
afgeretene	afrijten	WKW:VTD:VRB
afgeretenen	afrijten	WKW:VTD:MRV:DE_
afgescheidene	afscheiden	WKW:VTD:VRB
afgeschrevene	afschrijven	WKW:VTD:VRB
afgeslagene	afslaan	WKW:VTD:VRB
afgeslagenen	afslaan	WKW:VTD:MRV:DE_
afgesletene	afslijten	WKW:VTD:VRB
afgeslopene	afsluipen	WKW:VTD:VRB
afgeslopenen	afsluipen	WKW:VTD:MRV:DE_
afgeslotene	afsluiten	WKW:VTD:VRB
afgeslotenen	afsluiten	WKW:VTD:MRV:DE_
afgesnedene	afsnijden	WKW:VTD:VRB
afgesnedenen	afsnijden	WKW:VTD:MRV:DE_
afgesnotene	afsnuiten	WKW:VTD:VRB
afgespannene	afspannen	WKW:VTD:VRB
afgespannenen	afspannen	WKW:VTD:MRV:DE_
afgesponnene	afspinnen	WKW:VTD:VRB
afgesponnenen	afspinnen	WKW:VTD:MRV:DE_
afgespotene	afspuiten	WKW:VTD:VRB
afgespotenen	afspuiten	WKW:VTD:MRV:DE_
afgesprokene	afspreken	WKW:VTD:VRB
afgesprokenen	afspreken	WKW:VTD:MRV:DE_
afgestane	afstaan	WKW:VTD:VRB
afgestanen	afstaan	WKW:VTD:MRV:DE_
afgestegene	afstijgen	WKW:VTD:VRB
afgestegenen	afstijgen	WKW:VTD:MRV:DE_
afgestokene	afsteken	WKW:VTD:VRB
afgestolenen	afstelen	WKW:VTD:MRV:DE_
afgestorvene	afsterven	WKW:VTD:VRB
afgestotene	afstoten	WKW:VTD:VRB
afgetredene	aftreden	WKW:VTD:VRB
afgetrokkene	aftrekken	WKW:VTD:VRB
afgevallene	afvallen	WKW:VTD:EKV
afgevangenen	afvangen	WKW:VTD:MRV:DE_
afgewekene	afwijken	WKW:VTD:VRB
afgewezene	afwijzen	WKW:VTD:VRB
afgewogene	afwegen	WKW:VTD:VRB
afgewondene	afwinden	WKW:VTD:VRB
afgewondenen	afwinden	WKW:VTD:MRV:DE_
afgewonnene	afwinnen	WKW:VTD:VRB
afgewonnenen	afwinnen	WKW:VTD:MRV:DE_
afgeworpene	afwerpen	WKW:VTD:VRB
afgeworpenen	afwerpen	WKW:VTD:MRV:DE_
afgeworvene	afwerven	WKW:VTD:VRB
afgeworvenen	afwerven	WKW:VTD:MRV:DE_
afgewrongene	afwringen	WKW:VTD:VRB
afgewrongenen	afwringen	WKW:VTD:MRV:DE_
afgezetene	afzitten	WKW:VTD:VRB
afgezetenen	afzitten	WKW:VTD:MRV:DE_
afgezondene	afzenden	WKW:VTD:VRB
afgezopene	afzuipen	WKW:VTD:VRB
afgezopenen	afzuipen	WKW:VTD:MRV:DE_
afgezwommene	afzwemmen	WKW:VTD:VRB
afgezwommenen	afzwemmen	WKW:VTD:MRV:DE_
autogeredene	autorijden	WKW:VTD:VRB
autogeredenen	autorijden	WKW:VTD:MRV:DE_
bedongene	bedingen	WKW:VTD:VRB
bedorvene	bederven	WKW:VTD:VRB
bedorvenen	bederven	WKW:VTD:MRV:DE_
bedragene	bedragen	WKW:VTD:VRB
bedrevene	bedrijven	WKW:VTD:VRB
bedrogene	bedriegen	WKW:VTD:VRB
bedronkene	bedrinken	WKW:VTD:VRB
beetgegrepene	beetgrijpen	WKW:VTD:VRB
beetgegrepenen	beetgrijpen	WKW:VTD:MRV:DE_
beetgekregene	beetkrijgen	WKW:VTD:VRB
beganen	begaan	WKW:VTD:MRV:DE_
begonnene	beginnen	WKW:VTD:VRB
begonnenen	beginnen	WKW:VTD:MRV:DE_
begravene	begraven	WKW:VTD:VRB
begravenen	begraven	WKW:VTD:MRV:DE_
begrepene	begrijpen	WKW:VTD:VRB
behangene	behangen	WKW:VTD:VRB
behoudene	behouden	WKW:VTD:VRB
behoudenen	behouden	WKW:VTD:MRV:DE_
bekekene	bekijken	WKW:VTD:VRB
bekendgestane	bekendstaan	WKW:VTD:VRB
bekendgestanen	bekendstaan	WKW:VTD:MRV:DE_
beklommenen	beklimmen	WKW:VTD:MRV:DE_
beklonkene	beklinken	WKW:VTD:VRB
bekomene	bekomen	WKW:VTD:VRB
bekrompene	bekrimpen	WKW:VTD:EKV
beladene	beladen	WKW:VTD:VRB
beladenen	beladen	WKW:VTD:MRV:DE_
beledene	belijden	WKW:VTD:VRB
belezene	belezen	WKW:VTD:VRB
belezenen	belezen	WKW:VTD:MRV:DE_
bellengeblazene	bellenblazen	WKW:VTD:VRB
bellengeblazenen	bellenblazen	WKW:VTD:MRV:DE_
belogene	beliegen	WKW:VTD:VRB
benomene	benemen	WKW:VTD:VRB
benomenen	benemen	WKW:VTD:MRV:DE_
beredene	berijden	WKW:VTD:VRB
beredenen	berijden	WKW:VTD:MRV:DE_
beroepene	beroepen	WKW:VTD:VRB
beschetene	beschijten	WKW:VTD:VRB
beschetenen	beschijten	WKW:VTD:MRV:DE_
beschonkene	beschenken	WKW:VTD:VRB
beschotene	beschieten	WKW:VTD:VRB
beschrevene	beschrijven	WKW:VTD:VRB
beslagene	beslaan	WKW:VTD:VRB
beslotene	besluiten	WKW:VTD:VRB
besnedene	besnijden	WKW:VTD:VRB
bespannene	bespannen	WKW:VTD:VRB
bespotene	bespuiten	WKW:VTD:VRB
besprokene	bespreken	WKW:VTD:VRB
besprokenen	bespreken	WKW:VTD:MRV:DE_
besprongene	bespringen	WKW:VTD:VRB
besprongenen	bespringen	WKW:VTD:MRV:DE_
bestolene	bestelen	WKW:VTD:VRB
bestorvene	besterven	WKW:VTD:VRB
bestovene	bestuiven	WKW:VTD:VRB
bestredene	bestrijden	WKW:VTD:VRB
betredenen	betreden	WKW:VTD:MRV:DE_
betroffene	betreffen	WKW:VTD:VRB
betrokkene	betrekken	WKW:VTD:EKV
bevallene	bevallen	WKW:VTD:VRB
bevallenen	bevallen	WKW:VTD:MRV:DE_
bevangene	bevangen	WKW:VTD:EKV
bevangenen	bevangen	WKW:VTD:MRV:DE_
bevarenen	bevaren	WKW:VTD:MRV:DE_
bevlogene	bevliegen	WKW:VTD:VRB
bevochtene	bevechten	WKW:VTD:VRB
bevolene	bevelen	WKW:VTD:VRB
bevondene	bevinden	WKW:VTD:VRB
bevrorene	bevriezen	WKW:VTD:VRB
bevrorenen	bevriezen	WKW:VTD:MRV:DE_
bewassene	bewassen	WKW:VTD:VRB
bewezene	bewijzen	WKW:VTD:VRB
bewogene	bewegen	WKW:VTD:VRB
bezetene	bezitten	WKW:VTD:EKV
beziene	bezien	WKW:VTD:VRB
beziggehoudene	bezighouden	WKW:VTD:VRB
bezonkene	bezinken	WKW:VTD:VRB
bezonkenen	bezinken	WKW:VTD:MRV:DE_
bezonnene	bezinnen	WKW:VTD:VRB
bezonnenen	bezinnen	WKW:VTD:MRV:DE_
bezopene	bezuipen	WKW:VTD:VRB
bezworene	bezweren	WKW:VTD:VRB
biergebrouwene	bierbrouwen	WKW:VTD:VRB
biergebrouwenen	bierbrouwen	WKW:VTD:MRV:DE_
bijeengeblevene	bijeenblijven	WKW:VTD:VRB
bijeengeblevenen	bijeenblijven	WKW:VTD:MRV:DE_
bijeengebondene	bijeenbinden	WKW:VTD:VRB
bijeengebondenen	bijeenbinden	WKW:VTD:MRV:DE_
bijeengedrevene	bijeendrijven	WKW:VTD:VRB
bijeengehoudene	bijeenhouden	WKW:VTD:VRB
bijeengekomene	bijeenkomen	WKW:VTD:VRB
bijeengenomene	bijeennemen	WKW:VTD:VRB
bijeengeroepene	bijeenroepen	WKW:VTD:VRB
bijeengezetene	bijeenzitten	WKW:VTD:VRB
bijeengezetenen	bijeenzitten	WKW:VTD:MRV:DE_
bijgedronkene	bijdrinken	WKW:VTD:VRB
bijgegane	bijgaan	WKW:VTD:VRB
bijgeganen	bijgaan	WKW:VTD:MRV:DE_
bijgehangene	bijhangen	WKW:VTD:VRB
bijgehoudene	bijhouden	WKW:VTD:VRB
bijgekomenen	bijkomen	WKW:VTD:MRV:DE_
bijgeschrevene	bijschrijven	WKW:VTD:VRB
bijgeslotene	bijsluiten	WKW:VTD:VRB
bijgesnedene	bijsnijden	WKW:VTD:VRB
bijgestane	bijstaan	WKW:VTD:VRB
bijgestanen	bijstaan	WKW:VTD:MRV:DE_
binnengedane	binnendoen	WKW:VTD:VRB
binnengedanen	binnendoen	WKW:VTD:MRV:DE_
binnengegane	binnengaan	WKW:VTD:VRB
binnengeganen	binnengaan	WKW:VTD:MRV:DE_
binnengegledene	binnenglijden	WKW:VTD:VRB
binnengekomene	binnenkomen	WKW:VTD:VRB
binnengeredene	binnenrijden	WKW:VTD:VRB
binnengerevene	binnenrijven	WKW:VTD:VRB
binnengerevenen	binnenrijven	WKW:VTD:MRV:DE_
binnengeroepene	binnenroepen	WKW:VTD:VRB
binnengeslotene	binnengeslotene	WKW:VTD:VRB
binnengestane	binnenstaan	WKW:VTD:VRB
binnengestanen	binnenstaan	WKW:VTD:MRV:DE_
binnengetredene	binnentreden	WKW:VTD:VRB
binnengevallene	binnenvallen	WKW:VTD:VRB
blootgestane	blootstaan	WKW:VTD:VRB
blootgestanen	blootstaan	WKW:VTD:MRV:DE_
boekgehoudene	boekhouden	WKW:VTD:VRB
bovenbeschrevene	bovenbeschrevene	WKW:VTD:VRB
bovenbeschrevenen	bovenbeschrevenen	WKW:VTD:MRV:DE_
bovengestokenen	bovengestokenen	WKW:VTD:MRV:DE_
bruingebakkene	bruinbakken	WKW:VTD:VRB
bruingebakkenen	bruinbakken	WKW:VTD:MRV:DE_
buitengegane	buitengaan	WKW:VTD:VRB
buitengeganen	buitengaan	WKW:VTD:MRV:DE_
buitengehangene	buitenhangen	WKW:VTD:VRB
buitengehoudene	buitenhouden	WKW:VTD:VRB
buitengehoudenen	buitenhouden	WKW:VTD:MRV:DE_
buitengekekene	buitenkijken	WKW:VTD:VRB
buitengekekenen	buitenkijken	WKW:VTD:MRV:DE_
buitengelatene	buitenlaten	WKW:VTD:VRB
buitengeslotene	buitensluiten	WKW:VTD:VRB
buitengesmetene	buitengesmetene	WKW:VTD:VRB
buitengesmetenen	buitensmijten	WKW:VTD:MRV:DE_
buitengestane	buitenstaan	WKW:VTD:VRB
buitengestanen	buitenstaan	WKW:VTD:MRV:DE_
daargelatene	daarlaten	WKW:VTD:VRB
daargelatenen	daarlaten	WKW:VTD:MRV:DE_
deelgenomenen	deelnemen	WKW:VTD:MRV:DE_
dichtgebetene	dichtbijten	WKW:VTD:VRB
dichtgedane	dichtdoen	WKW:VTD:VRB
dichtgedanen	dichtdoen	WKW:VTD:MRV:DE_
dichtgegane	dichtgaan	WKW:VTD:VRB
dichtgeganen	dichtgaan	WKW:VTD:MRV:DE_
dichtgelopene	dichtlopen	WKW:VTD:VRB
dichtgelopenen	dichtlopen	WKW:VTD:MRV:DE_
dichtgeregene	dichtrijgen	WKW:VTD:VRB
dichtgeregenen	dichtrijgen	WKW:VTD:MRV:DE_
dichtgeslagene	dichtslaan	WKW:VTD:VRB
dichtgestane	dichtstaan	WKW:VTD:VRB
dichtgestanen	dichtstaan	WKW:VTD:MRV:DE_
dichtgestrekene	dichtstrijken	WKW:VTD:VRB
diepgevrorene	diepvriezen	WKW:VTD:VRB
diepgevrorenen	diepvriezen	WKW:VTD:MRV:DE_
doodgedane	dooddoen	WKW:VTD:VRB
doodgedanen	dooddoen	WKW:VTD:MRV:DE_
doodgeflotene	doodfluiten	WKW:VTD:VRB
doodgeflotenen	doodfluiten	WKW:VTD:MRV:DE_
doodgegane	doodgaan	WKW:VTD:VRB
doodgeganen	doodgaan	WKW:VTD:MRV:DE_
doodgeredene	doodrijden	WKW:VTD:VRB
doodgeschotenen	doodschieten	WKW:VTD:MRV:DE_
doodgeschrokkene	doodschrikken	WKW:VTD:VRB
doodgeschrokkenen	doodschrikken	WKW:VTD:MRV:DE_
doodgeslagene	doodslaan	WKW:VTD:VRB
doodgespotene	doodspuiten	WKW:VTD:VRB
doodgespotenen	doodspuiten	WKW:VTD:MRV:DE_
doodgestokene	doodsteken	WKW:VTD:VRB
doodgestokenen	doodsteken	WKW:VTD:MRV:DE_
doodgevallene	doodvallen	WKW:VTD:VRB
doodgezwegene	doodzwijgen	WKW:VTD:VRB
dooreengevlochtene	dooreenvlechten	WKW:VTD:VRB
dooreengevlochtenen	dooreenvlechten	WKW:VTD:MRV:DE_
dooreengeworpene	dooreenwerpen	WKW:VTD:VRB
doorgebakkene	doorgebakkene	WKW:VTD:VRB
doorgebodene	doorbieden	WKW:VTD:VRB
doorgebodenen	doorbieden	WKW:VTD:MRV:DE_
doorgebrokene	doorgebrokene	WKW:VTD:VRB
doorgebrokenen	doorbreken	WKW:VTD:MRV:DE_
doorgedane	doordoen	WKW:VTD:VRB
doorgedanen	doordoen	WKW:VTD:MRV:DE_
doorgedrevene	doordrijven	WKW:VTD:VRB
doorgedrongene	doorgedrongene	WKW:VTD:VRB
doorgegane	doorgaan	WKW:VTD:VRB
doorgeganen	doorgaan	WKW:VTD:MRV:DE_
doorgegevene	doorgegevene	WKW:VTD:VRB
doorgegevenen	doorgeven	WKW:VTD:MRV:DE_
doorgegledene	doorglijden	WKW:VTD:VRB
doorgeklommene	doorklimmen	WKW:VTD:VRB
doorgeklommenen	doorklimmen	WKW:VTD:MRV:DE_
doorgekozene	doorgekozene	WKW:VTD:VRB
doorgelatenen	doorlaten	WKW:VTD:MRV:DE_
doorgelopene	doorlopen	WKW:VTD:VRB
doorgelopenen	doorlopen	WKW:VTD:MRV:DE_
doorgemolkene	doormelken	WKW:VTD:VRB
doorgemolkenen	doormelken	WKW:VTD:MRV:DE_
doorgeplozene	doorpluizen	WKW:VTD:VRB
doorgeplozenen	doorpluizen	WKW:VTD:MRV:DE_
doorgeregene	doorgeregene	WKW:VTD:VRB
doorgeregenen	doorrijgen	WKW:VTD:MRV:DE_
doorgeslagene	doorslaan	WKW:VTD:VRB
doorgeslagenen	doorslaan	WKW:VTD:MRV:DE_
doorgesnedene	doorgesnedene	WKW:VTD:VRB
doorgesnedenen	doorsnijden	WKW:VTD:MRV:DE_
doorgesnovene	doorgesnovene	WKW:VTD:VRB
doorgesponnene	doorgesponnene	WKW:VTD:VRB
doorgesponnenen	doorspinnen	WKW:VTD:MRV:DE_
doorgespotene	doorspuiten	WKW:VTD:VRB
doorgespotenen	doorspuiten	WKW:VTD:MRV:DE_
doorgestane	doorstaan	WKW:VTD:VRB
doorgestanen	doorstaan	WKW:VTD:MRV:DE_
doorgetrokkene	doorgetrokkene	WKW:VTD:VRB
doorgetrokkenen	doortrekken	WKW:VTD:MRV:DE_
doorgevallene	doorgevallene	WKW:VTD:VRB
doorgeziene	doorzien	WKW:VTD:VRB
doorlopene	doorlopen	WKW:VTD:VRB
doorlopenen	doorlopen	WKW:VTD:MRV:DE_
doorsnedene	doorsnijden	WKW:VTD:VRB
doorsnedenen	doorsnijden	WKW:VTD:MRV:DE_
doorstane	doorstaan	WKW:VTD:VRB
doorstanen	doorstaan	WKW:VTD:MRV:DE_
doortrokkene	doortrekken	WKW:VTD:VRB
doortrokkenen	doortrekken	WKW:VTD:MRV:DE_
drooggebakkene	droogbakken	WKW:VTD:VRB
drooggebakkenen	droogbakken	WKW:VTD:MRV:DE_
drooggeblazene	droogblazen	WKW:VTD:VRB
drooggeblazenen	droogblazen	WKW:VTD:MRV:DE_
drooggelopene	drooglopen	WKW:VTD:VRB
drooggelopenen	drooglopen	WKW:VTD:MRV:DE_
drooggestane	droogstaan	WKW:VTD:VRB
drooggestanen	droogstaan	WKW:VTD:MRV:DE_
dubbelgebogene	dubbelbuigen	WKW:VTD:VRB
dubbelgebogenen	dubbelbuigen	WKW:VTD:MRV:DE_
dubbelgeslagene	dubbelslaan	WKW:VTD:VRB
dubbelgeslagenen	dubbelslaan	WKW:VTD:MRV:DE_
dubbelgevouwene	dubbelvouwen	WKW:VTD:VRB
dubbelgevouwenen	dubbelvouwen	WKW:VTD:MRV:DE_
dwarsgezetenen	dwarszitten	WKW:VTD:MRV:DE_
eerstaangewezene	eerstaangewezene	WKW:VTD:VRB
eerstaangewezenen	eerstaangewezenen	WKW:VTD:MRV:DE_
ervarene	ervaren	WKW:VTD:VRB
fijngeslagene	fijnslaan	WKW:VTD:VRB
fijngeslagenen	fijnslaan	WKW:VTD:MRV:DE_
fijngeslepene	fijnslijpen	WKW:VTD:VRB
fijngeslepenen	fijnslijpen	WKW:VTD:MRV:DE_
fijngesnedene	fijnsnijden	WKW:VTD:VRB
fijngewrevene	fijnwrijven	WKW:VTD:VRB
flauwgevallene	flauwvallen	WKW:VTD:VRB
gebakkene	bakken	WKW:VTD:VRB
gebakkenen	bakken	WKW:VTD:MRV:DE_
gebedene	bidden	WKW:VTD:VRB
gebetene	bijten	WKW:VTD:VRB
geblazene	blazen	WKW:VTD:VRB
geblekene	blijken	WKW:VTD:VRB
geblekenen	blijken	WKW:VTD:MRV:DE_
geblevene	blijven	WKW:VTD:VRB
geblevenen	blijven	WKW:VTD:MRV:DE_
gebodene	bieden	WKW:VTD:VRB
gebodenen	bieden	WKW:VTD:MRV:DE_
gebogene	buigen	WKW:VTD:VRB
gebondene	binden	WKW:VTD:VRB
gebondenen	binden	WKW:VTD:MRV:DE_
geborgene	bergen	WKW:VTD:VRB
geborgenen	bergen	WKW:VTD:MRV:DE_
gebrokene	breken	WKW:VTD:VRB
gebrouwene	brouwen	WKW:VTD:VRB
gedanen	doen	WKW:VTD:MRV:DE_
gedolvene	delven	WKW:VTD:VRB
gedolvenen	delven	WKW:VTD:MRV:DE_
gedragene	dragen	WKW:VTD:VRB
gedragenen	dragen	WKW:VTD:MRV:DE_
gedrevene	drijven	WKW:VTD:VRB
gedrongene	dringen	WKW:VTD:VRB
gedrongenen	dringen	WKW:VTD:MRV:DE_
gedronkene	drinken	WKW:VTD:VRB
gedwongene	dwingen	WKW:VTD:VRB
gegane	gaan	WKW:VTD:EKV
geganen	gaan	WKW:VTD:MRV:DE_
gegetene	eten	WKW:VTD:VRB
gegevene	geven	WKW:VTD:VRB
gegevenen	geven	WKW:VTD:MRV:DE_
gegotene	gieten	WKW:VTD:VRB
gegotenen	gieten	WKW:VTD:MRV:DE_
gegravene	graven	WKW:VTD:VRB
gegravenen	graven	WKW:VTD:MRV:DE_
gegrepene	grijpen	WKW:VTD:VRB
gehangene	hangen	WKW:VTD:VRB
gehetene	heten	WKW:VTD:VRB
gehevene	heffen	WKW:VTD:VRB
gehoevene	hoeven	WKW:VTD:VRB
geholpene	helpen	WKW:VTD:VRB
gehoudene	houden	WKW:VTD:VRB
gehoudenen	houden	WKW:VTD:MRV:DE_
geklommene	klimmen	WKW:VTD:VRB
geknepene	knijpen	WKW:VTD:VRB
gekomene	komen	WKW:VTD:VRB
gekomenen	komen	WKW:VTD:MRV:DE_
gekozene	kiezen	WKW:VTD:VRB
gekregene	krijgen	WKW:VTD:VRB
gekropene	kruipen	WKW:VTD:VRB
geladene	laden	WKW:VTD:VRB
gelatene	laten	WKW:VTD:VRB
geledene	lijden	WKW:VTD:VRB
geledenen	lijden	WKW:VTD:MRV:DE_
gelegene	liggen	WKW:VTD:EKV
gelegenen	liggen	WKW:VTD:MRV:DE_
gelekene	lijken	WKW:VTD:VRB
gelezene	lezen	WKW:VTD:VRB
gelezenen	lezen	WKW:VTD:MRV:DE_
gelijkgestane	gelijkstaan	WKW:VTD:VRB
gelijkgestanen	gelijkstaan	WKW:VTD:MRV:DE_
gelijkgetrokkene	gelijktrekken	WKW:VTD:VRB
gelijkgetrokkenen	gelijktrekken	WKW:VTD:MRV:DE_
gelogenen	liegen	WKW:VTD:MRV:DE_
gelokene	luiken	WKW:VTD:VRB
gelopene	lopen	WKW:VTD:VRB
gelopenen	lopen	WKW:VTD:MRV:DE_
gemalene	malen	WKW:VTD:VRB
gemedene	mijden	WKW:VTD:VRB
gemetene	meten	WKW:VTD:VRB
gemetenen	meten	WKW:VTD:MRV:DE_
gemoetene	moeten	WKW:VTD:VRB
gemogene	mogen	WKW:VTD:VRB
gemogenen	mogen	WKW:VTD:MRV:DE_
gemolkene	melken	WKW:VTD:VRB
gemolkenen	melken	WKW:VTD:MRV:DE_
genezene	genezen	WKW:VTD:VRB
genezenen	genezen	WKW:VTD:MRV:DE_
genomene	nemen	WKW:VTD:VRB
genotene	genieten	WKW:VTD:VRB
genotenen	genieten	WKW:VTD:MRV:DE_
geprezene	prijzen	WKW:VTD:VRB
geprezenen	prijzen	WKW:VTD:MRV:DE_
geredene	rijden	WKW:VTD:VRB
geredenen	rijden	WKW:VTD:MRV:DE_
gereedgehoudene	gereedhouden	WKW:VTD:VRB
gereedgehoudenen	gereedhouden	WKW:VTD:MRV:DE_
gereedgelegene	gereedliggen	WKW:VTD:VRB
gereedgelegenen	gereedliggen	WKW:VTD:MRV:DE_
gereedgestane	gereedstaan	WKW:VTD:VRB
gereedgestanen	gereedstaan	WKW:VTD:MRV:DE_
geretene	rijten	WKW:VTD:VRB
gerevene	rijven	WKW:VTD:VRB
gerevenen	rijven	WKW:VTD:MRV:DE_
gerezene	rijzen	WKW:VTD:VRB
geroepene	roepen	WKW:VTD:VRB
gerokene	rieken	WKW:VTD:VRB
gescheidene	scheiden	WKW:VTD:VRB
geschenene	schijnen	WKW:VTD:VRB
geschetene	schijten	WKW:VTD:VRB
geschetenen	schijten	WKW:VTD:MRV:DE_
geschondene	schenden	WKW:VTD:VRB
geschonkene	schenken	WKW:VTD:VRB
geschorene	scheren	WKW:VTD:VRB
geschorenen	scheren	WKW:VTD:MRV:DE_
geschotene	schieten	WKW:VTD:VRB
geschrevene	schrijven	WKW:VTD:VRB
geschrokkene	schrikken	WKW:VTD:VRB
geschrokkenen	schrikken	WKW:VTD:MRV:DE_
geslagene	slaan	WKW:VTD:VRB
geslagenen	slaan	WKW:VTD:MRV:DE_
geslepene	slijpen	WKW:VTD:VRB
geslotene	sluiten	WKW:VTD:VRB
gesmoltene	smelten	WKW:VTD:VRB
gesnedene	snijden	WKW:VTD:VRB
gesnedenen	snijden	WKW:VTD:MRV:DE_
gespannene	spannen	WKW:VTD:VRB
gespannenen	spannen	WKW:VTD:MRV:DE_
gespletene	splijten	WKW:VTD:VRB
gespletenen	splijten	WKW:VTD:MRV:DE_
gesponnene	spinnen	WKW:VTD:VRB
gespotene	spuiten	WKW:VTD:VRB
gespotenen	spuiten	WKW:VTD:MRV:DE_
gesprokene	spreken	WKW:VTD:VRB
gestane	staan	WKW:VTD:VRB
gestanen	staan	WKW:VTD:MRV:DE_
gestegenen	stijgen	WKW:VTD:MRV:DE_
gestokene	steken	WKW:VTD:VRB
gestolene	stelen	WKW:VTD:VRB
gestonkene	stinken	WKW:VTD:VRB
gestonkenen	stinken	WKW:VTD:MRV:DE_
gestotene	stoten	WKW:VTD:VRB
gestrekene	strijken	WKW:VTD:VRB
getogenen	tijgen	WKW:VTD:MRV:DE_
getredene	treden	WKW:VTD:VRB
getroffene	treffen	WKW:VTD:VRB
getrokkene	trekken	WKW:VTD:VRB
gevallene	vallen	WKW:VTD:VRB
gevangene	vangen	WKW:VTD:EKV
gevangengenomenen	gevangennemen	WKW:VTD:MRV:DE_
gevlogenen	vliegen	WKW:VTD:MRV:DE_
gevochtene	vechten	WKW:VTD:VRB
gevondene	vinden	WKW:VTD:VRB
gevondenen	vinden	WKW:VTD:MRV:DE_
gevouwene	vouwen	WKW:VTD:VRB
gevretene	vreten	WKW:VTD:VRB
gevrorene	vriezen	WKW:VTD:VRB
gevrorenen	vriezen	WKW:VTD:MRV:DE_
gewaargewordene	gewaarworden	WKW:VTD:VRB
gewaargewordenen	gewaarworden	WKW:VTD:MRV:DE_
gewassene	wassen	WKW:VTD:VRB
gewekene	wijken	WKW:VTD:VRB
gewekenen	wijken	WKW:VTD:MRV:DE_
gewetene	weten	WKW:VTD:VRB
gewetenen	weten	WKW:VTD:MRV:DE_
gewezene	wijzen	WKW:VTD:VRB
gewogene	wegen	WKW:VTD:VRB
gewondene	winden	WKW:VTD:VRB
gewonnene	winnen	WKW:VTD:VRB
gewonnenen	winnen	WKW:VTD:MRV:DE_
gewordene	worden	WKW:VTD:VRB
gewordenen	worden	WKW:VTD:MRV:DE_
geworpene	werpen	WKW:VTD:VRB
geworvenen	werven	WKW:VTD:MRV:DE_
gewrevene	wrijven	WKW:VTD:VRB
gewrevenen	wrijven	WKW:VTD:MRV:DE_
gewrokene	wreken	WKW:VTD:VRB
gewrongene	wringen	WKW:VTD:VRB
gezetene	zitten	WKW:VTD:VRB
geziene	zien	WKW:VTD:EKV
gezondene	zenden	WKW:VTD:VRB
gezongene	zingen	WKW:VTD:VRB
gezonkene	zinken	WKW:VTD:VRB
gezonkenen	zinken	WKW:VTD:MRV:DE_
gezwollene	zwellen	WKW:VTD:VRB
gezwommenen	zwemmen	WKW:VTD:MRV:DE_
gezworvene	zwerven	WKW:VTD:VRB
gladgeschorene	gladscheren	WKW:VTD:VRB
gladgeschorenen	gladscheren	WKW:VTD:MRV:DE_
gladgeslepene	gladslijpen	WKW:VTD:VRB
gladgeslepenen	gladslijpen	WKW:VTD:MRV:DE_
gladgetrokkene	gladtrekken	WKW:VTD:VRB
gladgetrokkenen	gladtrekken	WKW:VTD:MRV:DE_
gladgewrevene	gladwrijven	WKW:VTD:VRB
gladgewrevenen	gladwrijven	WKW:VTD:MRV:DE_
goedgedane	goeddoen	WKW:VTD:VRB
goedgedanen	goeddoen	WKW:VTD:MRV:DE_
goedgehoudene	goedhouden	WKW:VTD:VRB
goedgehoudenen	goedhouden	WKW:VTD:MRV:DE_
goedgesprokene	goedspreken	WKW:VTD:VRB
grijsgeredene	grijsrijden	WKW:VTD:VRB
grijsgeredenen	grijsrijden	WKW:VTD:MRV:DE_
grootgehoudene	groothouden	WKW:VTD:VRB
grootgehoudenen	groothouden	WKW:VTD:MRV:DE_
handelgedrevene	handeldrijven	WKW:VTD:VRB
handgeschrevene	handgeschrevene	WKW:VTD:VRB
hardgeredene	hardrijden	WKW:VTD:VRB
hardgeredenen	hardrijden	WKW:VTD:MRV:DE_
heengegane	heengaan	WKW:VTD:VRB
heengeganen	heengaan	WKW:VTD:MRV:DE_
heengeslagene	heenslaan	WKW:VTD:VRB
heraangeslotene	heraansluiten	WKW:VTD:VRB
heraangeslotenen	heraansluiten	WKW:VTD:MRV:DE_
herbegravene	herbegraven	WKW:VTD:VRB
herbegravenen	herbegraven	WKW:VTD:MRV:DE_
herbeziene	herbezien	WKW:VTD:VRB
herbezienen	herbezien	WKW:VTD:MRV:DE_
herbezonnene	herbezinnen	WKW:VTD:VRB
herbezonnenen	herbezinnen	WKW:VTD:MRV:DE_
heringetredene	herintreden	WKW:VTD:VRB
heringetredenen	herintreden	WKW:VTD:MRV:DE_
heropgeladene	heropladen	WKW:VTD:VRB
heroverwogene	heroverwegen	WKW:VTD:VRB
heroverwogenen	heroverwegen	WKW:VTD:MRV:DE_
herrezene	herrijzen	WKW:VTD:VRB
herschapene	herscheppen	WKW:VTD:VRB
heruitgezondene	heruitzenden	WKW:VTD:VRB
hervallene	hervallen	WKW:VTD:VRB
herverbondene	herverbinden	WKW:VTD:VRB
herverzondene	herverzenden	WKW:VTD:VRB
herverzondenen	herverzenden	WKW:VTD:MRV:DE_
hervondene	hervinden	WKW:VTD:VRB
herziene	herzien	WKW:VTD:VRB
hongergeledene	hongerlijden	WKW:VTD:VRB
hongergeledenen	hongerlijden	WKW:VTD:MRV:DE_
hooggehoudene	hooghouden	WKW:VTD:VRB
hooggesprongene	hoogspringen	WKW:VTD:VRB
hooggesprongenen	hoogspringen	WKW:VTD:MRV:DE_
hooggezetenen	hoogzitten	WKW:VTD:MRV:DE_
houtgesnedene	houtsnijden	WKW:VTD:VRB
houtgesnedenen	houtsnijden	WKW:VTD:MRV:DE_
ineengedokene	ineenduiken	WKW:VTD:VRB
ineengedokenen	ineenduiken	WKW:VTD:MRV:DE_
ineengegrepene	ineengrijpen	WKW:VTD:VRB
ineengegrepenen	ineengrijpen	WKW:VTD:MRV:DE_
ineengelopene	ineenlopen	WKW:VTD:VRB
ineengelopenen	ineenlopen	WKW:VTD:MRV:DE_
ineengeschovene	ineenschuiven	WKW:VTD:VRB
ineengeschovenen	ineenschuiven	WKW:VTD:MRV:DE_
ineengestokene	ineensteken	WKW:VTD:VRB
ineengestokenen	ineensteken	WKW:VTD:MRV:DE_
ineengevlochtene	ineenvlechten	WKW:VTD:VRB
ineengevlochtenen	ineenvlechten	WKW:VTD:MRV:DE_
ineengevouwene	ineenvouwen	WKW:VTD:VRB
ineengevouwenen	ineenvouwen	WKW:VTD:MRV:DE_
ineengezegene	ineenzijgen	WKW:VTD:VRB
ineengezegenen	ineenzijgen	WKW:VTD:MRV:DE_
ineengezetene	ineenzitten	WKW:VTD:VRB
ineengezetenen	ineenzitten	WKW:VTD:MRV:DE_
ingeblevene	inblijven	WKW:VTD:VRB
ingeblevenen	inblijven	WKW:VTD:MRV:DE_
ingebrokene	inbreken	WKW:VTD:VRB
ingedrongene	indringen	WKW:VTD:VRB
ingegane	ingaan	WKW:VTD:VRB
ingeganen	ingaan	WKW:VTD:MRV:DE_
ingegevene	ingeven	WKW:VTD:VRB
ingegevenen	ingeven	WKW:VTD:MRV:DE_
ingegledene	inglijden	WKW:VTD:VRB
ingegravene	ingraven	WKW:VTD:VRB
ingegravenen	ingraven	WKW:VTD:MRV:DE_
ingegrepene	ingrijpen	WKW:VTD:VRB
ingegrepenen	ingrijpen	WKW:VTD:MRV:DE_
ingehangene	inhangen	WKW:VTD:VRB
ingehesene	inhijsen	WKW:VTD:VRB
ingehesenen	inhijsen	WKW:VTD:MRV:DE_
ingehoudene	inhouden	WKW:VTD:VRB
ingehoudenen	inhouden	WKW:VTD:MRV:DE_
ingekekene	inkijken	WKW:VTD:VRB
ingekekenen	inkijken	WKW:VTD:MRV:DE_
ingeklommene	inklimmen	WKW:VTD:VRB
ingekomene	inkomen	WKW:VTD:VRB
ingelatene	inlaten	WKW:VTD:VRB
ingelezene	inlezen	WKW:VTD:VRB
ingenomene	innemen	WKW:VTD:VRB
ingeprezene	inprijzen	WKW:VTD:VRB
ingeprezenen	inprijzen	WKW:VTD:MRV:DE_
ingeschorene	inscheren	WKW:VTD:VRB
ingeschorenen	inscheren	WKW:VTD:MRV:DE_
ingeschovene	inschuiven	WKW:VTD:VRB
ingeschrevene	inschrijven	WKW:VTD:VRB
ingeslagene	inslaan	WKW:VTD:VRB
ingeslapene	inslapen	WKW:VTD:VRB
ingeslepene	inslijpen	WKW:VTD:VRB
ingeslepenen	inslijpen	WKW:VTD:MRV:DE_
ingeslopene	insluipen	WKW:VTD:VRB
ingeslotene	insluiten	WKW:VTD:VRB
ingesmoltene	insmelten	WKW:VTD:VRB
ingesmoltenen	insmelten	WKW:VTD:MRV:DE_
ingesnedene	insnijden	WKW:VTD:VRB
ingesnedenen	insnijden	WKW:VTD:MRV:DE_
ingesnovene	insnuiven	WKW:VTD:VRB
ingespannene	inspannen	WKW:VTD:VRB
ingespotenen	inspuiten	WKW:VTD:MRV:DE_
ingesprokene	inspreken	WKW:VTD:VRB
ingesprokenen	inspreken	WKW:VTD:MRV:DE_
ingestane	instaan	WKW:VTD:VRB
ingestanen	instaan	WKW:VTD:MRV:DE_
ingestegene	instijgen	WKW:VTD:VRB
ingestegenen	instijgen	WKW:VTD:MRV:DE_
ingestonkene	instinken	WKW:VTD:VRB
ingestonkenen	instinken	WKW:VTD:MRV:DE_
ingestotene	instoten	WKW:VTD:VRB
ingetredene	intreden	WKW:VTD:VRB
ingetredenen	intreden	WKW:VTD:MRV:DE_
ingetrokkene	intrekken	WKW:VTD:VRB
ingevangene	invangen	WKW:VTD:VRB
ingevlochtene	invlechten	WKW:VTD:VRB
ingevlochtenen	invlechten	WKW:VTD:MRV:DE_
ingevochtene	invechten	WKW:VTD:VRB
ingevochtenen	invechten	WKW:VTD:MRV:DE_
ingevrorenen	invriezen	WKW:VTD:MRV:DE_
ingewekene	inwijken	WKW:VTD:VRB
ingewekenen	inwijken	WKW:VTD:MRV:DE_
ingewogene	inwegen	WKW:VTD:VRB
ingewogenen	inwegen	WKW:VTD:MRV:DE_
ingewondene	inwinden	WKW:VTD:VRB
ingewonnene	inwinnen	WKW:VTD:VRB
ingewonnenen	inwinnen	WKW:VTD:MRV:DE_
ingezetene	inzitten	WKW:VTD:VRB
ingeziene	inzien	WKW:VTD:VRB
ingezondene	inzenden	WKW:VTD:VRB
ingezonkene	inzinken	WKW:VTD:VRB
ingezwommene	inzwemmen	WKW:VTD:VRB
ingezwommenen	inzwemmen	WKW:VTD:MRV:DE_
kaalgegetene	kaaleten	WKW:VTD:VRB
kaalgeschorenen	kaalscheren	WKW:VTD:MRV:DE_
kaalgevretene	kaalvreten	WKW:VTD:VRB
kaalgevretenen	kaalvreten	WKW:VTD:MRV:DE_
kaartgelezene	kaartlezen	WKW:VTD:VRB
kaartgelezenen	kaartlezen	WKW:VTD:MRV:DE_
kapotgebetene	kapotbijten	WKW:VTD:VRB
kapotgebetenen	kapotbijten	WKW:VTD:MRV:DE_
kapotgegane	kapotgaan	WKW:VTD:VRB
kapotgeganen	kapotgaan	WKW:VTD:MRV:DE_
kapotgeredene	kapotrijden	WKW:VTD:VRB
kapotgeredenen	kapotrijden	WKW:VTD:MRV:DE_
kapotgeschrevene	kapotschrijven	WKW:VTD:VRB
kapotgeschrevenen	kapotschrijven	WKW:VTD:MRV:DE_
kapotgeslagene	kapotslaan	WKW:VTD:VRB
kapotgeslagenen	kapotslaan	WKW:VTD:MRV:DE_
kapotgesmetene	kapotsmijten	WKW:VTD:VRB
kapotgesmetenen	kapotsmijten	WKW:VTD:MRV:DE_
kapotgesnedene	kapotsnijden	WKW:VTD:VRB
kapotgesnedenen	kapotsnijden	WKW:VTD:MRV:DE_
kapotgesprongene	kapotspringen	WKW:VTD:VRB
kapotgesprongenen	kapotspringen	WKW:VTD:MRV:DE_
kapotgetrokkene	kapottrekken	WKW:VTD:VRB
kapotgetrokkenen	kapottrekken	WKW:VTD:MRV:DE_
kapotgevallene	kapotvallen	WKW:VTD:VRB
kapotgevrorene	kapotvriezen	WKW:VTD:VRB
kapotgevrorenen	kapotvriezen	WKW:VTD:MRV:DE_
kennisgegevene	kennisgeven	WKW:VTD:VRB
kennisgegevenen	kennisgeven	WKW:VTD:MRV:DE_
kleingekregene	kleinkrijgen	WKW:VTD:VRB
kleingesnedene	kleinsnijden	WKW:VTD:VRB
kleingesnedenen	kleinsnijden	WKW:VTD:MRV:DE_
kromgebogene	krombuigen	WKW:VTD:VRB
kromgebogenen	krombuigen	WKW:VTD:MRV:DE_
kromgelegene	kromliggen	WKW:VTD:VRB
kromgelegenen	kromliggen	WKW:VTD:MRV:DE_
kromgeslotene	kromsluiten	WKW:VTD:VRB
kromgetrokkene	kromtrekken	WKW:VTD:VRB
kromgetrokkenen	kromtrekken	WKW:VTD:MRV:DE_
kuitgeschotene	kuitschieten	WKW:VTD:VRB
kuitgeschotenen	kuitschieten	WKW:VTD:MRV:DE_
kwaadgesprokene	kwaadspreken	WKW:VTD:VRB
kwaadgesprokenen	kwaadspreken	WKW:VTD:MRV:DE_
laaggevlogene	laagvliegen	WKW:VTD:VRB
laaggevlogenen	laagvliegen	WKW:VTD:MRV:DE_
laatstgekozenen	laatstgekozenen	WKW:VTD:MRV:DE_
lamgeslagene	lamslaan	WKW:VTD:VRB
lamgeslagenen	lamslaan	WKW:VTD:MRV:DE_
langsgedrevene	langsdrijven	WKW:VTD:VRB
langsgegane	langsgaan	WKW:VTD:VRB
langsgeganen	langsgaan	WKW:VTD:MRV:DE_
langsgegledene	langsglijden	WKW:VTD:VRB
langsgekomene	langskomen	WKW:VTD:VRB
langsgeschotene	langsschieten	WKW:VTD:VRB
langsgeschotenen	langsschieten	WKW:VTD:MRV:DE_
langsgetrokkene	langstrekken	WKW:VTD:VRB
langsgetrokkenen	langstrekken	WKW:VTD:MRV:DE_
leeggeblazene	leegblazen	WKW:VTD:VRB
leeggeblazenen	leegblazen	WKW:VTD:MRV:DE_
leeggegetene	leegeten	WKW:VTD:VRB
leeggegetenen	leegeten	WKW:VTD:MRV:DE_
leeggeknepene	leegknijpen	WKW:VTD:VRB
leeggeknepenen	leegknijpen	WKW:VTD:MRV:DE_
leeggemalene	leegmalen	WKW:VTD:VRB
leeggemalenen	leegmalen	WKW:VTD:MRV:DE_
leeggemolkene	leegmelken	WKW:VTD:VRB
leeggemolkenen	leegmelken	WKW:VTD:MRV:DE_
leeggestane	leegstaan	WKW:VTD:VRB
leeggestanen	leegstaan	WKW:VTD:MRV:DE_
leeggetrokkene	leegtrekken	WKW:VTD:VRB
leeggetrokkenen	leegtrekken	WKW:VTD:MRV:DE_
leidinggegevene	leidinggeven	WKW:VTD:VRB
leidinggegevenen	leidinggeven	WKW:VTD:MRV:DE_
lekgeredene	lekrijden	WKW:VTD:VRB
lekgeredenen	lekrijden	WKW:VTD:MRV:DE_
lekgestokene	leksteken	WKW:VTD:VRB
lekgestokenen	leksteken	WKW:VTD:MRV:DE_
losgegane	losgaan	WKW:VTD:VRB
losgeganen	losgaan	WKW:VTD:MRV:DE_
losgelatene	loslaten	WKW:VTD:VRB
losgeredene	losrijden	WKW:VTD:VRB
losgeredenen	losrijden	WKW:VTD:MRV:DE_
losgesnedene	lossnijden	WKW:VTD:VRB
losgesnedenen	lossnijden	WKW:VTD:MRV:DE_
losgestane	losstaan	WKW:VTD:VRB
losgestanen	losstaan	WKW:VTD:MRV:DE_
losgestokene	lossteken	WKW:VTD:VRB
losgestokenen	lossteken	WKW:VTD:MRV:DE_
losgezongenen	loszingen	WKW:VTD:MRV:DE_
maatgehoudene	maathouden	WKW:VTD:VRB
meebegravene	meebegraven	WKW:VTD:VRB
meebegravenen	meebegraven	WKW:VTD:MRV:DE_
meegebondene	meebinden	WKW:VTD:VRB
meegebondenen	meebinden	WKW:VTD:MRV:DE_
meegedane	meedoen	WKW:VTD:VRB
meegedanen	meedoen	WKW:VTD:MRV:DE_
meegedokene	meeduiken	WKW:VTD:VRB
meegedokenen	meeduiken	WKW:VTD:MRV:DE_
meegegane	meegaan	WKW:VTD:VRB
meegeganen	meegaan	WKW:VTD:MRV:DE_
meegegetene	mee-eten	WKW:VTD:VRB
meegegetenen	mee-eten	WKW:VTD:MRV:DE_
meegegledene	meeglijden	WKW:VTD:VRB
meegegledenen	meeglijden	WKW:VTD:MRV:DE_
meegegotene	meegieten	WKW:VTD:VRB
meegegotenen	meegieten	WKW:VTD:MRV:DE_
meegekomene	meekomen	WKW:VTD:VRB
meegemetene	meemeten	WKW:VTD:VRB
meegemetenen	meemeten	WKW:VTD:MRV:DE_
meegeroepene	meeroepen	WKW:VTD:VRB
meegestegene	meestijgen	WKW:VTD:VRB
meegestegenen	meestijgen	WKW:VTD:MRV:DE_
meegevallene	meevallen	WKW:VTD:VRB
meegewassene	meewassen	WKW:VTD:VRB
meegezogene	meezuigen	WKW:VTD:VRB
meegezogenen	meezuigen	WKW:VTD:MRV:DE_
meeontbetene	meeontbijten	WKW:VTD:VRB
meeontbetenen	meeontbijten	WKW:VTD:MRV:DE_
meeontworpene	meeontwerpen	WKW:VTD:VRB
meeontworpenen	meeontwerpen	WKW:VTD:MRV:DE_
misdane	misdoen	WKW:VTD:VRB
misdanen	misdoen	WKW:VTD:MRV:DE_
misgegane	misgaan	WKW:VTD:VRB
misgeganen	misgaan	WKW:VTD:MRV:DE_
misgekekene	miskijken	WKW:VTD:VRB
misgekekenen	miskijken	WKW:VTD:MRV:DE_
misgeslagene	misslaan	WKW:VTD:VRB
misgestane	misstaan	WKW:VTD:VRB
misgestanen	misstaan	WKW:VTD:MRV:DE_
misverstane	misverstaan	WKW:VTD:VRB
misverstanen	misverstaan	WKW:VTD:MRV:DE_
mooigezetene	mooizitten	WKW:VTD:VRB
mooigezetenen	mooizitten	WKW:VTD:MRV:DE_
naaktgelopene	naaktlopen	WKW:VTD:VRB
naaktgelopenen	naaktlopen	WKW:VTD:MRV:DE_
nabijgekomene	nabijkomen	WKW:VTD:VRB
nabijgekomenen	nabijkomen	WKW:VTD:MRV:DE_
nagebakkene	nabakken	WKW:VTD:VRB
nagebakkenen	nabakken	WKW:VTD:MRV:DE_
nagebedene	nabidden	WKW:VTD:VRB
nagebedenen	nabidden	WKW:VTD:MRV:DE_
nagedane	nadoen	WKW:VTD:VRB
nagedanen	nadoen	WKW:VTD:MRV:DE_
nagedokene	naduiken	WKW:VTD:VRB
nagedokenen	naduiken	WKW:VTD:MRV:DE_
nagedronkene	nadrinken	WKW:VTD:VRB
nagedronkenen	nadrinken	WKW:VTD:MRV:DE_
nageflotene	nafluiten	WKW:VTD:VRB
nageflotenen	nafluiten	WKW:VTD:MRV:DE_
nagegane	nagaan	WKW:VTD:VRB
nageganen	nagaan	WKW:VTD:MRV:DE_
nagehevene	naheffen	WKW:VTD:VRB
nageklommene	naklimmen	WKW:VTD:VRB
nageklommenen	naklimmen	WKW:VTD:MRV:DE_
nagekomene	nakomen	WKW:VTD:VRB
nagelatene	nalaten	WKW:VTD:VRB
nagelatenen	nalaten	WKW:VTD:MRV:DE_
nagelopene	nalopen	WKW:VTD:VRB
nagemetene	nameten	WKW:VTD:VRB
nagemetenen	nameten	WKW:VTD:MRV:DE_
nageplozene	napluizen	WKW:VTD:VRB
nageplozenen	napluizen	WKW:VTD:MRV:DE_
nageredene	narijden	WKW:VTD:VRB
nageredenen	narijden	WKW:VTD:MRV:DE_
nagerezene	narijzen	WKW:VTD:VRB
nagerezenen	narijzen	WKW:VTD:MRV:DE_
nageslagene	naslaan	WKW:VTD:VRB
nageslepene	naslijpen	WKW:VTD:VRB
nageslepenen	naslijpen	WKW:VTD:MRV:DE_
nagesnedene	nasnijden	WKW:VTD:VRB
nagesnedenen	nasnijden	WKW:VTD:MRV:DE_
nagespannene	naspannen	WKW:VTD:VRB
nagespannenen	naspannen	WKW:VTD:MRV:DE_
nagesprokene	naspreken	WKW:VTD:VRB
nagewassene	nawassen	WKW:VTD:VRB
nagewezene	nawijzen	WKW:VTD:VRB
nagewezenen	nawijzen	WKW:VTD:MRV:DE_
nagewogene	nawegen	WKW:VTD:VRB
nagewogenen	nawegen	WKW:VTD:MRV:DE_
nageworpene	nawerpen	WKW:VTD:VRB
nageworpenen	nawerpen	WKW:VTD:MRV:DE_
nageziene	nazien	WKW:VTD:VRB
natgehoudene	nathouden	WKW:VTD:VRB
natgeschorene	natscheren	WKW:VTD:VRB
natgeschorenen	natscheren	WKW:VTD:MRV:DE_
natgespotene	natspuiten	WKW:VTD:VRB
natgespotenen	natspuiten	WKW:VTD:MRV:DE_
neergegane	neergaan	WKW:VTD:VRB
neergeganen	neergaan	WKW:VTD:MRV:DE_
neergekekene	neerkijken	WKW:VTD:VRB
neergelatene	neerlaten	WKW:VTD:VRB
neergeschenene	neerschijnen	WKW:VTD:VRB
neergeschenenen	neerschijnen	WKW:VTD:MRV:DE_
neergeschotene	neerschieten	WKW:VTD:VRB
neergestokene	neersteken	WKW:VTD:VRB
neergestotene	neerstoten	WKW:VTD:VRB
neergetrokkene	neertrekken	WKW:VTD:VRB
neergetrokkenen	neertrekken	WKW:VTD:MRV:DE_
neergeziene	neerzien	WKW:VTD:VRB
neergezondene	neerzenden	WKW:VTD:VRB
neergezondenen	neerzenden	WKW:VTD:MRV:DE_
omgeblazene	omblazen	WKW:VTD:VRB
omgeblazenen	omblazen	WKW:VTD:MRV:DE_
omgedane	omdoen	WKW:VTD:VRB
omgedanen	omdoen	WKW:VTD:MRV:DE_
omgegane	omgaan	WKW:VTD:VRB
omgeganen	omgaan	WKW:VTD:MRV:DE_
omgegevene	omgeven	WKW:VTD:VRB
omgegevenen	omgeven	WKW:VTD:MRV:DE_
omgegotene	omgieten	WKW:VTD:VRB
omgegotenen	omgieten	WKW:VTD:MRV:DE_
omgegravene	omgraven	WKW:VTD:VRB
omgegravenen	omgraven	WKW:VTD:MRV:DE_
omgehoudene	omhouden	WKW:VTD:VRB
omgeklonkene	omklinken	WKW:VTD:VRB
omgeklonkenen	omklinken	WKW:VTD:MRV:DE_
omgekomene	omkomen	WKW:VTD:VRB
omgeladene	omladen	WKW:VTD:VRB
omgeredene	omrijden	WKW:VTD:VRB
omgeredenen	omrijden	WKW:VTD:MRV:DE_
omgeschrevene	omschrijven	WKW:VTD:VRB
omgeschrevenen	omschrijven	WKW:VTD:MRV:DE_
omgeslagene	omslaan	WKW:VTD:VRB
omgespotene	omspuiten	WKW:VTD:VRB
omgespotenen	omspuiten	WKW:VTD:MRV:DE_
omgestokene	omsteken	WKW:VTD:VRB
omgestokenen	omsteken	WKW:VTD:MRV:DE_
omgestotene	omstoten	WKW:VTD:VRB
omgevene	omgeven	WKW:VTD:VRB
omgevenen	omgeven	WKW:VTD:MRV:DE_
omgevouwene	omvouwen	WKW:VTD:VRB
omgevouwenen	omvouwen	WKW:VTD:MRV:DE_
omgewassene	omwassen	WKW:VTD:VRB
omgewassenen	omwassen	WKW:VTD:MRV:DE_
omgezetene	omzitten	WKW:VTD:VRB
omgeziene	omzien	WKW:VTD:VRB
omgezienen	omzien	WKW:VTD:MRV:DE_
omhooggedane	omhoogdoen	WKW:VTD:VRB
omhooggedanen	omhoogdoen	WKW:VTD:MRV:DE_
omhooggedrevene	omhoogdrijven	WKW:VTD:VRB
omhooggegane	omhooggaan	WKW:VTD:VRB
omhooggeganen	omhooggaan	WKW:VTD:MRV:DE_
omhooggegledene	omhoogglijden	WKW:VTD:VRB
omhooggehangene	omhooghangen	WKW:VTD:VRB
omhooggehesene	omhooghijsen	WKW:VTD:VRB
omhooggehesenen	omhooghijsen	WKW:VTD:MRV:DE_
omhooggehevene	omhoogheffen	WKW:VTD:VRB
omhooggehevenen	omhoogheffen	WKW:VTD:MRV:DE_
omhooggehoudene	omhooghouden	WKW:VTD:VRB
omhooggekekene	omhoogkijken	WKW:VTD:VRB
omhooggekekenen	omhoogkijken	WKW:VTD:MRV:DE_
omhooggeklommene	omhoogklimmen	WKW:VTD:VRB
omhooggeklommenen	omhoogklimmen	WKW:VTD:MRV:DE_
omhooggekomene	omhoogkomen	WKW:VTD:VRB
omhooggekropene	omhoogkruipen	WKW:VTD:VRB
omhooggekropenen	omhoogkruipen	WKW:VTD:MRV:DE_
omhooggelopene	omhooglopen	WKW:VTD:VRB
omhooggelopenen	omhooglopen	WKW:VTD:MRV:DE_
omhooggeredene	omhoogrijden	WKW:VTD:VRB
omhooggeredenen	omhoogrijden	WKW:VTD:MRV:DE_
omhooggeschotene	omhoogschieten	WKW:VTD:VRB
omhooggeschotenen	omhoogschieten	WKW:VTD:MRV:DE_
omhooggeslagene	omhoogslaan	WKW:VTD:VRB
omhooggeslagenen	omhoogslaan	WKW:VTD:MRV:DE_
omhooggespotene	omhoogspuiten	WKW:VTD:VRB
omhooggespotenen	omhoogspuiten	WKW:VTD:MRV:DE_
omhooggestegene	omhoogstijgen	WKW:VTD:VRB
omhooggestegenen	omhoogstijgen	WKW:VTD:MRV:DE_
omhooggestokene	omhoogsteken	WKW:VTD:VRB
omhooggestokenen	omhoogsteken	WKW:VTD:MRV:DE_
omhooggetrokkene	omhoogtrekken	WKW:VTD:VRB
omhooggetrokkenen	omhoogtrekken	WKW:VTD:MRV:DE_
omhooggevallene	omhoogvallen	WKW:VTD:VRB
omhooggewezene	omhoogwijzen	WKW:VTD:VRB
omhooggezetene	omhoogzitten	WKW:VTD:VRB
omhooggezetenen	omhoogzitten	WKW:VTD:MRV:DE_
omlaaggegane	omlaaggaan	WKW:VTD:VRB
omlaaggeganen	omlaaggaan	WKW:VTD:MRV:DE_
omlaaggegledene	omlaagglijden	WKW:VTD:VRB
omlaaggehangene	omlaaghangen	WKW:VTD:VRB
omlaaggekekene	omlaagkijken	WKW:VTD:VRB
omlaaggekekenen	omlaagkijken	WKW:VTD:MRV:DE_
omlaaggekomene	omlaagkomen	WKW:VTD:VRB
omlaaggekomenen	omlaagkomen	WKW:VTD:MRV:DE_
omlaaggetrokkene	omlaagtrekken	WKW:VTD:VRB
omlaaggetrokkenen	omlaagtrekken	WKW:VTD:MRV:DE_
omlaaggevallene	omlaagvallen	WKW:VTD:VRB
omschrevene	omschrijven	WKW:VTD:VRB
omschrevenen	omschrijven	WKW:VTD:MRV:DE_
omslotene	omsluiten	WKW:VTD:VRB
omslotenen	omsluiten	WKW:VTD:MRV:DE_
omvergeblazene	omverblazen	WKW:VTD:VRB
omvergeblazenen	omverblazen	WKW:VTD:MRV:DE_
omvergelopene	omverlopen	WKW:VTD:VRB
omvergelopenen	omverlopen	WKW:VTD:MRV:DE_
omvergeslagene	omverslaan	WKW:VTD:VRB
omvergeslagenen	omverslaan	WKW:VTD:MRV:DE_
omvergestotene	omverstoten	WKW:VTD:VRB
omvergetrokkene	omvertrekken	WKW:VTD:VRB
omvergetrokkenen	omvertrekken	WKW:VTD:MRV:DE_
omvergevallene	omvervallen	WKW:VTD:VRB
omvergeworpenen	omverwerpen	WKW:VTD:MRV:DE_
ondergane	ondergaan	WKW:VTD:VRB
onderganen	ondergaan	WKW:VTD:MRV:DE_
ondergedokene	onderduiken	WKW:VTD:VRB
ondergegane	ondergaan	WKW:VTD:VRB
ondergeganen	ondergaan	WKW:VTD:MRV:DE_
ondergegravene	ondergegravene	WKW:VTD:VRB
ondergegravenen	ondergegravenen	WKW:VTD:MRV:DE_
ondergehoudene	onderhouden	WKW:VTD:VRB
ondergeschovenen	onderschuiven	WKW:VTD:MRV:DE_
ondergespotene	onderspuiten	WKW:VTD:VRB
ondergespotenen	onderspuiten	WKW:VTD:MRV:DE_
ondergestovene	onderstuiven	WKW:VTD:VRB
ondergestovenen	onderstuiven	WKW:VTD:MRV:DE_
ondergravene	ondergraven	WKW:VTD:VRB
ondergravenen	ondergraven	WKW:VTD:MRV:DE_
onderhoudenen	onderhouden	WKW:VTD:MRV:DE_
onderschatten	onderschatten	WKW:VTD:MRV:DE_
onderscheidene	onderscheiden	WKW:VTD:VRB
onderscheidenen	onderscheiden	WKW:VTD:MRV:DE_
onderschrevene	onderschrijven	WKW:VTD:VRB
onderschrevenen	onderschrijven	WKW:VTD:MRV:DE_
onderuitgegane	onderuitgaan	WKW:VTD:VRB
onderuitgeganen	onderuitgaan	WKW:VTD:MRV:DE_
onderuitgegledene	onderuitglijden	WKW:VTD:VRB
onderuitgegledenen	onderuitglijden	WKW:VTD:MRV:DE_
ondervangene	ondervangen	WKW:VTD:VRB
ondervangenen	ondervangen	WKW:VTD:MRV:DE_
ontbetene	ontbijten	WKW:VTD:VRB
ontbetenen	ontbijten	WKW:VTD:MRV:DE_
ontbodene	ontbieden	WKW:VTD:VRB
ontbondene	ontbinden	WKW:VTD:EKV
ontbrokene	ontbreken	WKW:VTD:VRB
ontgane	ontgaan	WKW:VTD:VRB
ontganen	ontgaan	WKW:VTD:MRV:DE_
ontgravene	ontgraven	WKW:VTD:VRB
ontgravenen	ontgraven	WKW:VTD:MRV:DE_
onthevene	ontheffen	WKW:VTD:VRB
onthoudene	onthouden	WKW:VTD:VRB
onthoudenen	onthouden	WKW:VTD:MRV:DE_
ontkomene	ontkomen	WKW:VTD:VRB
ontlatene	ontlaten	WKW:VTD:VRB
ontlatenen	ontlaten	WKW:VTD:MRV:DE_
ontlokene	ontluiken	WKW:VTD:VRB
ontlopene	ontlopen	WKW:VTD:VRB
ontnomene	ontnemen	WKW:VTD:VRB
ontslagene	ontslaan	WKW:VTD:VRB
ontslapene	ontslapen	WKW:VTD:VRB
ontslotene	ontsluiten	WKW:VTD:VRB
ontspannene	ontspannen	WKW:VTD:VRB
ontspannenen	ontspannen	WKW:VTD:MRV:DE_
ontsprotene	ontspruiten	WKW:VTD:VRB
ontstanen	ontstaan	WKW:VTD:MRV:DE_
ontstegene	ontstijgen	WKW:VTD:VRB
ontstokene	ontsteken	WKW:VTD:VRB
ontstolene	ontstelen	WKW:VTD:VRB
ontstolenen	ontstelen	WKW:VTD:MRV:DE_
onttrokkene	onttrekken	WKW:VTD:VRB
ontvallene	ontvallen	WKW:VTD:VRB
ontvangene	ontvangen	WKW:VTD:VRB
ontvlodene	ontvlieden	WKW:VTD:VRB
ontvlodenen	ontvlieden	WKW:VTD:MRV:DE_
ontvouwene	ontvouwen	WKW:VTD:VRB
ontvouwenen	ontvouwen	WKW:VTD:MRV:DE_
ontwekene	ontwijken	WKW:VTD:VRB
ontworpene	ontwerpen	WKW:VTD:VRB
ontworpenen	ontwerpen	WKW:VTD:MRV:DE_
ontziene	ontzien	WKW:VTD:VRB
opeengedrongene	opeendringen	WKW:VTD:VRB
opeengedrongenen	opeendringen	WKW:VTD:MRV:DE_
opengebrokenen	openbreken	WKW:VTD:MRV:DE_
opengedane	opendoen	WKW:VTD:VRB
opengedanen	opendoen	WKW:VTD:MRV:DE_
opengegane	opengaan	WKW:VTD:VRB
opengeganen	opengaan	WKW:VTD:MRV:DE_
opengegledene	openglijden	WKW:VTD:VRB
opengegravene	opengraven	WKW:VTD:VRB
opengegravenen	opengraven	WKW:VTD:MRV:DE_
opengehoudene	openhouden	WKW:VTD:VRB
opengekregene	openkrijgen	WKW:VTD:VRB
opengeslagene	openslaan	WKW:VTD:VRB
opengeslepene	openslijpen	WKW:VTD:VRB
opengeslepenen	openslijpen	WKW:VTD:MRV:DE_
opengeslotene	opensluiten	WKW:VTD:VRB
opengesmetene	opensmijten	WKW:VTD:VRB
opengesmetenen	opensmijten	WKW:VTD:MRV:DE_
opengesnedene	opensnijden	WKW:VTD:VRB
opengestane	openstaan	WKW:VTD:VRB
opengestanen	openstaan	WKW:VTD:MRV:DE_
opengestokene	opensteken	WKW:VTD:VRB
opengestokenen	opensteken	WKW:VTD:MRV:DE_
opengestotene	openstoten	WKW:VTD:VRB
opengewrevene	openwrijven	WKW:VTD:VRB
opengewrevenen	openwrijven	WKW:VTD:MRV:DE_
opengewrongene	openwringen	WKW:VTD:VRB
opengewrongenen	openwringen	WKW:VTD:MRV:DE_
opgeblazene	opblazen	WKW:VTD:VRB
opgeblazenen	opblazen	WKW:VTD:MRV:DE_
opgeborgene	opbergen	WKW:VTD:VRB
opgebrokene	opbreken	WKW:VTD:VRB
opgebrokenen	opbreken	WKW:VTD:MRV:DE_
opgedane	opdoen	WKW:VTD:VRB
opgedanen	opdoen	WKW:VTD:MRV:DE_
opgedokenen	opduiken	WKW:VTD:MRV:DE_
opgedolvene	opdelven	WKW:VTD:VRB
opgedolvenen	opdelven	WKW:VTD:MRV:DE_
opgedragene	opdragen	WKW:VTD:VRB
opgedrongenen	opdringen	WKW:VTD:MRV:DE_
opgedwongene	opdwingen	WKW:VTD:VRB
opgedwongenen	opdwingen	WKW:VTD:MRV:DE_
opgegane	opgaan	WKW:VTD:VRB
opgeganen	opgaan	WKW:VTD:MRV:DE_
opgegetene	opeten	WKW:VTD:VRB
opgegevene	opgeven	WKW:VTD:VRB
opgegravene	opgraven	WKW:VTD:VRB
opgegravenen	opgraven	WKW:VTD:MRV:DE_
opgehangene	ophangen	WKW:VTD:VRB
opgehevene	opheffen	WKW:VTD:VRB
opgehoudene	ophouden	WKW:VTD:VRB
opgehoudenen	ophouden	WKW:VTD:MRV:DE_
opgeklommene	opklimmen	WKW:VTD:VRB
opgeklommenen	opklimmen	WKW:VTD:MRV:DE_
opgelatene	oplaten	WKW:VTD:VRB
opgelezene	oplezen	WKW:VTD:VRB
opgelokene	opluiken	WKW:VTD:VRB
opgelokenen	opluiken	WKW:VTD:MRV:DE_
opgelopene	oplopen	WKW:VTD:VRB
opgemalene	opmalen	WKW:VTD:VRB
opgemalenen	opmalen	WKW:VTD:MRV:DE_
opgenomene	opnemen	WKW:VTD:VRB
opgeregene	oprijgen	WKW:VTD:VRB
opgeregenen	oprijgen	WKW:VTD:MRV:DE_
opgeretene	oprijten	WKW:VTD:VRB
opgeretenen	oprijten	WKW:VTD:MRV:DE_
opgerezene	oprijzen	WKW:VTD:VRB
opgeroepene	oproepen	WKW:VTD:VRB
opgeschorene	opscheren	WKW:VTD:VRB
opgeschorenen	opscheren	WKW:VTD:MRV:DE_
opgeschrevene	opschrijven	WKW:VTD:VRB
opgeslagene	opslaan	WKW:VTD:VRB
opgeslagenen	opslaan	WKW:VTD:MRV:DE_
opgeslopene	opsluipen	WKW:VTD:VRB
opgeslopenen	opsluipen	WKW:VTD:MRV:DE_
opgeslotene	opsluiten	WKW:VTD:VRB
opgesmoltene	opsmelten	WKW:VTD:VRB
opgesmoltenen	opsmelten	WKW:VTD:MRV:DE_
opgesnedene	opsnijden	WKW:VTD:VRB
opgespannene	opspannen	WKW:VTD:VRB
opgespannenen	opspannen	WKW:VTD:MRV:DE_
opgestane	opstaan	WKW:VTD:VRB
opgestanen	opstaan	WKW:VTD:MRV:DE_
opgestegene	opstijgen	WKW:VTD:VRB
opgestegenen	opstijgen	WKW:VTD:MRV:DE_
opgestotene	opstoten	WKW:VTD:VRB
opgetredene	optreden	WKW:VTD:VRB
opgetrokkene	optrekken	WKW:VTD:VRB
opgevangene	opvangen	WKW:VTD:VRB
opgevarene	opvaren	WKW:VTD:VRB
opgevarenen	opvaren	WKW:VTD:MRV:DE_
opgevezene	opvijzen	WKW:VTD:VRB
opgevezenen	opvijzen	WKW:VTD:MRV:DE_
opgevlogene	opvliegen	WKW:VTD:VRB
opgevlogenen	opvliegen	WKW:VTD:MRV:DE_
opgevretene	opvreten	WKW:VTD:VRB
opgewassene	opwassen	WKW:VTD:VRB
opgewassenen	opwassen	WKW:VTD:MRV:DE_
opgewogene	opwegen	WKW:VTD:VRB
opgewogenen	opwegen	WKW:VTD:MRV:DE_
opgewondene	opwinden	WKW:VTD:VRB
opgewondenen	opwinden	WKW:VTD:MRV:DE_
opgezetene	opzitten	WKW:VTD:VRB
opgezogene	opzuigen	WKW:VTD:VRB
opgezogenen	opzuigen	WKW:VTD:MRV:DE_
opgezwollene	opzwellen	WKW:VTD:VRB
opgezwollenen	opzwellen	WKW:VTD:MRV:DE_
opzijgedane	opzijdoen	WKW:VTD:VRB
opzijgedanen	opzijdoen	WKW:VTD:MRV:DE_
opzijgegane	opzijgaan	WKW:VTD:VRB
opzijgeganen	opzijgaan	WKW:VTD:MRV:DE_
opzijgehoudene	opzijhouden	WKW:VTD:VRB
opzijgehoudenen	opzijhouden	WKW:VTD:MRV:DE_
opzijgekekene	opzijkijken	WKW:VTD:VRB
opzijgekekenen	opzijkijken	WKW:VTD:MRV:DE_
opzijgeschovene	opzijschuiven	WKW:VTD:VRB
opzijgeschovenen	opzijschuiven	WKW:VTD:MRV:DE_
opzijgesprongene	opzijspringen	WKW:VTD:VRB
opzijgesprongenen	opzijspringen	WKW:VTD:MRV:DE_
opzijgetrokkene	opzijtrekken	WKW:VTD:VRB
opzijgetrokkenen	opzijtrekken	WKW:VTD:MRV:DE_
overbeladene	overbeladen	WKW:VTD:VRB
overdrevene	overdrijven	WKW:VTD:VRB
overdrevenen	overdrijven	WKW:VTD:MRV:DE_
overgebakkene	overbakken	WKW:VTD:VRB
overgebakkenen	overbakken	WKW:VTD:MRV:DE_
overgeblevene	overblijven	WKW:VTD:VRB
overgedane	overdoen	WKW:VTD:VRB
overgedanen	overdoen	WKW:VTD:MRV:DE_
overgedragene	overdragen	WKW:VTD:VRB
overgedragenen	overdragen	WKW:VTD:MRV:DE_
overgedrevene	overdrijven	WKW:VTD:VRB
overgegane	overgaan	WKW:VTD:VRB
overgeganen	overgaan	WKW:VTD:MRV:DE_
overgehoudene	overhouden	WKW:VTD:VRB
overgehoudenen	overhouden	WKW:VTD:MRV:DE_
overgekomene	overkomen	WKW:VTD:VRB
overgelatene	overlaten	WKW:VTD:VRB
overgelegene	overliggen	WKW:VTD:VRB
overgelegenen	overliggen	WKW:VTD:MRV:DE_
overgelopene	overgelopene	WKW:VTD:VRB
overgelopenen	overgelopenen	WKW:VTD:MRV:DE_
overgenomene	overnemen	WKW:VTD:VRB
overgeredene	overrijden	WKW:VTD:VRB
overgeredenen	overrijden	WKW:VTD:MRV:DE_
overgeroepene	overroepen	WKW:VTD:VRB
overgeschonkene	overschenken	WKW:VTD:VRB
overgeschonkenen	overschenken	WKW:VTD:MRV:DE_
overgeschrevene	overschrijven	WKW:VTD:VRB
overgeschrevenen	overschrijven	WKW:VTD:MRV:DE_
overgeslagene	overslaan	WKW:VTD:VRB
overgeslotene	oversluiten	WKW:VTD:VRB
overgespotene	overspuiten	WKW:VTD:VRB
overgespotenen	overspuiten	WKW:VTD:MRV:DE_
overgestokene	oversteken	WKW:VTD:VRB
overgetredene	overgetredene	WKW:VTD:VRB
overgevarene	overvaren	WKW:VTD:VRB
overgevarenen	overvaren	WKW:VTD:MRV:DE_
overgewogene	overwegen	WKW:VTD:VRB
overgewogenen	overwegen	WKW:VTD:MRV:DE_
overgewonnene	overwinnen	WKW:VTD:VRB
overgewonnenen	overwinnen	WKW:VTD:MRV:DE_
overhoopgelegene	overhoopliggen	WKW:VTD:VRB
overhoopgelegenen	overhoopliggen	WKW:VTD:MRV:DE_
overhoopgestokene	overhoopsteken	WKW:VTD:VRB
overhoopgestokenen	overhoopsteken	WKW:VTD:MRV:DE_
overlopene	overlopen	WKW:VTD:VRB
overlopenen	overlopen	WKW:VTD:MRV:DE_
overredene	overrijden	WKW:VTD:VRB
overredenen	overrijden	WKW:VTD:MRV:DE_
overschredene	overschrijden	WKW:VTD:VRB
overschredenen	overschrijden	WKW:VTD:MRV:DE_
overschrevene	overschrevene	WKW:VTD:VRB
overschrevenen	overschrevenen	WKW:VTD:MRV:DE_
overtredene	overtreden	WKW:VTD:VRB
overtredenen	overtreden	WKW:VTD:MRV:DE_
overtroffene	overtreffen	WKW:VTD:VRB
overtroffenen	overtreffen	WKW:VTD:MRV:DE_
overwonnene	overwinnen	WKW:VTD:VRB
paardgeredene	paardrijden	WKW:VTD:VRB
paardgeredenen	paardrijden	WKW:VTD:MRV:DE_
paardjegeredene	paardjerijden	WKW:VTD:VRB
paardjegeredenen	paardjerijden	WKW:VTD:MRV:DE_
parachutegesprongene	parachutespringen	WKW:VTD:VRB
parachutegesprongenen	parachutespringen	WKW:VTD:MRV:DE_
partijgetrokkene	partijtrekken	WKW:VTD:VRB
partijgetrokkenen	partijtrekken	WKW:VTD:MRV:DE_
platgegane	platgaan	WKW:VTD:VRB
platgeganen	platgaan	WKW:VTD:MRV:DE_
platgespotene	platspuiten	WKW:VTD:VRB
platgespotenen	platspuiten	WKW:VTD:MRV:DE_
platgestrekene	platstrijken	WKW:VTD:VRB
platgestrekenen	platstrijken	WKW:VTD:MRV:DE_
platgetredene	plattreden	WKW:VTD:VRB
platgetredenen	plattreden	WKW:VTD:MRV:DE_
prijsgegevenen	prijsgeven	WKW:VTD:MRV:DE_
proefgelezene	proeflezen	WKW:VTD:VRB
proefgelezenen	proeflezen	WKW:VTD:MRV:DE_
proefgevarene	proefvaren	WKW:VTD:VRB
proefgevarenen	proefvaren	WKW:VTD:MRV:DE_
rechtgekomene	rechtkomen	WKW:VTD:VRB
rechtgesprongene	rechtspringen	WKW:VTD:VRB
rechtgesprongenen	rechtspringen	WKW:VTD:MRV:DE_
rechtgestane	rechtstaan	WKW:VTD:VRB
rechtgestanen	rechtstaan	WKW:VTD:MRV:DE_
riviergebondene	riviergebondene	WKW:VTD:VRB
roergebakkene	roerbakken	WKW:VTD:VRB
roergebakkenen	roerbakken	WKW:VTD:MRV:DE_
rondgebogene	rondbuigen	WKW:VTD:VRB
rondgebogenen	rondbuigen	WKW:VTD:MRV:DE_
rondgegane	rondgaan	WKW:VTD:VRB
rondgeganen	rondgaan	WKW:VTD:MRV:DE_
rondgeredene	rondrijden	WKW:VTD:VRB
rondgeredenen	rondrijden	WKW:VTD:MRV:DE_
rondgeslepene	rondslijpen	WKW:VTD:VRB
rondgeslepenen	rondslijpen	WKW:VTD:MRV:DE_
rondgesprokene	rondspreken	WKW:VTD:VRB
samengegane	samengaan	WKW:VTD:VRB
samengeganen	samengaan	WKW:VTD:MRV:DE_
samengegotene	samengieten	WKW:VTD:VRB
samengegotenen	samengieten	WKW:VTD:MRV:DE_
samengelezene	samenlezen	WKW:VTD:VRB
samengelezenen	samenlezen	WKW:VTD:MRV:DE_
samengeredene	samenrijden	WKW:VTD:VRB
samengeredenen	samenrijden	WKW:VTD:MRV:DE_
samengestokene	samensteken	WKW:VTD:VRB
samengestokenen	samensteken	WKW:VTD:MRV:DE_
samengetrokkene	samentrekken	WKW:VTD:VRB
samengevlochtene	samenvlechten	WKW:VTD:VRB
samengevlochtenen	samenvlechten	WKW:VTD:MRV:DE_
samengevouwene	samenvouwen	WKW:VTD:VRB
samengevouwenen	samenvouwen	WKW:VTD:MRV:DE_
scheefgelopene	scheeflopen	WKW:VTD:VRB
scheefgelopenen	scheeflopen	WKW:VTD:MRV:DE_
scheefgeslagene	scheefslaan	WKW:VTD:VRB
scheefgeslagenen	scheefslaan	WKW:VTD:MRV:DE_
scheefgetrokkene	scheeftrekken	WKW:VTD:VRB
scheefgetrokkenen	scheeftrekken	WKW:VTD:MRV:DE_
scheelgekekene	scheelkijken	WKW:VTD:VRB
scheelgekekenen	scheelkijken	WKW:VTD:MRV:DE_
scheelgeziene	scheelzien	WKW:VTD:VRB
scheelgezienen	scheelzien	WKW:VTD:MRV:DE_
schoolgeblevene	schoolblijven	WKW:VTD:VRB
schoolgeblevenen	schoolblijven	WKW:VTD:MRV:DE_
schoolgegane	schoolgaan	WKW:VTD:VRB
schoolgeganen	schoolgaan	WKW:VTD:MRV:DE_
schoolgehoudene	schoolhouden	WKW:VTD:VRB
schoolgehoudenen	schoolhouden	WKW:VTD:MRV:DE_
schoolgelopene	schoollopen	WKW:VTD:VRB
schoolgelopenen	schoollopen	WKW:VTD:MRV:DE_
schoongeblazene	schoonblazen	WKW:VTD:VRB
schoongeblazenen	schoonblazen	WKW:VTD:MRV:DE_
schoongesnedene	schoonsnijden	WKW:VTD:VRB
schoongesnedenen	schoonsnijden	WKW:VTD:MRV:DE_
schoongespotene	schoonspuiten	WKW:VTD:VRB
schoongespotenen	schoonspuiten	WKW:VTD:MRV:DE_
schoongewassene	schoonwassen	WKW:VTD:VRB
schoongewassenen	schoonwassen	WKW:VTD:MRV:DE_
schoongezogene	schoonzuigen	WKW:VTD:VRB
schoongezogenen	schoonzuigen	WKW:VTD:MRV:DE_
schootgegane	schootgaan	WKW:VTD:VRB
schootgeganen	schootgaan	WKW:VTD:MRV:DE_
seizoensgebondene	seizoensgebondene	WKW:VTD:VRB
skigelopene	skilopen	WKW:VTD:VRB
skigelopenen	skilopen	WKW:VTD:MRV:DE_
speergeworpene	speerwerpen	WKW:VTD:VRB
speergeworpenen	speerwerpen	WKW:VTD:MRV:DE_
standgehoudene	standhouden	WKW:VTD:VRB
stilgelegene	stilliggen	WKW:VTD:VRB
stilgelegenen	stilliggen	WKW:VTD:MRV:DE_
stilgestane	stilstaan	WKW:VTD:VRB
stilgestanen	stilstaan	WKW:VTD:MRV:DE_
stormgelopene	stormlopen	WKW:VTD:VRB
stormgelopenen	stormlopen	WKW:VTD:MRV:DE_
strakgetrokkene	straktrekken	WKW:VTD:VRB
strakgetrokkenen	straktrekken	WKW:VTD:MRV:DE_
streekgebondene	streekgebondene	WKW:VTD:VRB
stukgebrokene	stukbreken	WKW:VTD:VRB
stukgebrokenen	stukbreken	WKW:VTD:MRV:DE_
stukgegane	stukgaan	WKW:VTD:VRB
stukgelezene	stuklezen	WKW:VTD:VRB
stukgelezenen	stuklezen	WKW:VTD:MRV:DE_
stukgeredene	stukrijden	WKW:VTD:VRB
stukgeredenen	stukrijden	WKW:VTD:MRV:DE_
stukgeschotene	stukschieten	WKW:VTD:VRB
stukgeschotenen	stukschieten	WKW:VTD:MRV:DE_
stukgeslagene	stukslaan	WKW:VTD:VRB
stukgeslagenen	stukslaan	WKW:VTD:MRV:DE_
stukgesnedene	stuksnijden	WKW:VTD:VRB
stukgesnedenen	stuksnijden	WKW:VTD:MRV:DE_
stukgesprongene	stukspringen	WKW:VTD:VRB
stukgesprongenen	stukspringen	WKW:VTD:MRV:DE_
stukgestokene	stuksteken	WKW:VTD:VRB
stukgestokenen	stuksteken	WKW:VTD:MRV:DE_
stukgetrokkene	stuktrekken	WKW:VTD:VRB
stukgetrokkenen	stuktrekken	WKW:VTD:MRV:DE_
stukgevallene	stukvallen	WKW:VTD:VRB
stukgevrorene	stukvriezen	WKW:VTD:VRB
stukgevrorenen	stukvriezen	WKW:VTD:MRV:DE_
tegemoetgelopene	tegemoetlopen	WKW:VTD:VRB
tegemoetgelopenen	tegemoetlopen	WKW:VTD:MRV:DE_
tegemoetgeredene	tegemoetrijden	WKW:VTD:VRB
tegemoetgeredenen	tegemoetrijden	WKW:VTD:MRV:DE_
tegemoetgeziene	tegemoetzien	WKW:VTD:VRB
tegemoetgezienen	tegemoetzien	WKW:VTD:MRV:DE_
tegengegane	tegengaan	WKW:VTD:VRB
tegengeganen	tegengaan	WKW:VTD:MRV:DE_
tegengegetene	tegeneten	WKW:VTD:VRB
tegengehoudene	tegenhouden	WKW:VTD:VRB
tegengehoudenen	tegenhouden	WKW:VTD:MRV:DE_
tegengelachene	tegenlachen	WKW:VTD:VRB
tegengelachenen	tegenlachen	WKW:VTD:MRV:DE_
tegengelezene	tegenlezen	WKW:VTD:VRB
tegengelezenen	tegenlezen	WKW:VTD:MRV:DE_
tegengeslagene	tegenslaan	WKW:VTD:VRB
tegengeslagenen	tegenslaan	WKW:VTD:MRV:DE_
tegengesprokene	tegenspreken	WKW:VTD:VRB
tegengeworpene	tegenwerpen	WKW:VTD:VRB
tekeergeganen	tekeergaan	WKW:VTD:MRV:DE_
tekortgedane	tekortdoen	WKW:VTD:VRB
tekortgedanen	tekortdoen	WKW:VTD:MRV:DE_
televisiegekekene	televisiekijken	WKW:VTD:VRB
televisiegekekenen	televisiekijken	WKW:VTD:MRV:DE_
teloorgegane	teloorgaan	WKW:VTD:VRB
teloorgeganen	teloorgaan	WKW:VTD:MRV:DE_
tenietgedanen	tenietdoen	WKW:VTD:MRV:DE_
tenietgegane	tenietgaan	WKW:VTD:VRB
tenietgeganen	tenietgaan	WKW:VTD:MRV:DE_
terechtgekomene	terechtkomen	WKW:VTD:VRB
terechtgestane	terechtstaan	WKW:VTD:VRB
terechtgestanen	terechtstaan	WKW:VTD:MRV:DE_
terechtgewezene	terechtwijzen	WKW:VTD:VRB
terechtgewezenen	terechtwijzen	WKW:VTD:MRV:DE_
terneergelegene	terneerliggen	WKW:VTD:VRB
terneergelegenen	terneerliggen	WKW:VTD:MRV:DE_
terneergeslagene	terneerslaan	WKW:VTD:VRB
terneergeslagenen	terneerslaan	WKW:VTD:MRV:DE_
teruggeblazene	terugblazen	WKW:VTD:VRB
teruggeblazenen	terugblazen	WKW:VTD:MRV:DE_
teruggebrokene	terugbreken	WKW:VTD:VRB
teruggebrokenen	terugbreken	WKW:VTD:MRV:DE_
teruggedane	terugdoen	WKW:VTD:VRB
teruggedanen	terugdoen	WKW:VTD:MRV:DE_
teruggegane	teruggaan	WKW:VTD:VRB
teruggeganen	teruggaan	WKW:VTD:MRV:DE_
teruggegledene	terugglijden	WKW:VTD:VRB
teruggegledenen	terugglijden	WKW:VTD:MRV:DE_
teruggehangene	terughangen	WKW:VTD:VRB
teruggehoudene	terughouden	WKW:VTD:VRB
teruggehoudenen	terughouden	WKW:VTD:MRV:DE_
teruggekomene	terugkomen	WKW:VTD:VRB
teruggekregene	terugkrijgen	WKW:VTD:VRB
teruggekropene	terugkruipen	WKW:VTD:VRB
teruggekropenen	terugkruipen	WKW:VTD:MRV:DE_
teruggelachene	teruglachen	WKW:VTD:VRB
teruggelachenen	teruglachen	WKW:VTD:MRV:DE_
teruggeschonkene	terugschenken	WKW:VTD:VRB
teruggeschonkenen	terugschenken	WKW:VTD:MRV:DE_
teruggeschovene	terugschuiven	WKW:VTD:VRB
teruggeschovenen	terugschuiven	WKW:VTD:MRV:DE_
teruggeschrokkene	terugschrikken	WKW:VTD:VRB
teruggeschrokkenen	terugschrikken	WKW:VTD:MRV:DE_
teruggeslopene	terugsluipen	WKW:VTD:VRB
teruggeslopenen	terugsluipen	WKW:VTD:MRV:DE_
teruggesnedene	terugsnijden	WKW:VTD:VRB
teruggesnedenen	terugsnijden	WKW:VTD:MRV:DE_
teruggestokene	terugsteken	WKW:VTD:VRB
teruggestokenen	terugsteken	WKW:VTD:MRV:DE_
teruggestolene	terugstelen	WKW:VTD:VRB
teruggestolenen	terugstelen	WKW:VTD:MRV:DE_
teruggetrokkene	terugtrekken	WKW:VTD:VRB
teruggetrokkenen	terugtrekken	WKW:VTD:MRV:DE_
teruggevallene	terugvallen	WKW:VTD:VRB
teruggevangene	terugvangen	WKW:VTD:VRB
teruggevondene	terugvinden	WKW:VTD:VRB
teruggevouwene	terugvouwen	WKW:VTD:VRB
teruggevouwenen	terugvouwen	WKW:VTD:MRV:DE_
teruggewonnene	terugwinnen	WKW:VTD:VRB
teruggewonnenen	terugwinnen	WKW:VTD:MRV:DE_
teruggeworpene	terugwerpen	WKW:VTD:VRB
teruggeziene	terugzien	WKW:VTD:VRB
teruggezwommene	terugzwemmen	WKW:VTD:VRB
teruggezwommenen	terugzwemmen	WKW:VTD:MRV:DE_
theegedronkene	theedrinken	WKW:VTD:VRB
theegedronkenen	theedrinken	WKW:VTD:MRV:DE_
thuisgeblevene	thuisblijven	WKW:VTD:VRB
thuisgeblevenen	thuisblijven	WKW:VTD:MRV:DE_
thuisgekregene	thuiskrijgen	WKW:VTD:VRB
thuisgezetene	thuiszitten	WKW:VTD:VRB
thuisgezetenen	thuiszitten	WKW:VTD:MRV:DE_
toegedrevene	toedrijven	WKW:VTD:VRB
toegegane	toegaan	WKW:VTD:VRB
toegeganen	toegaan	WKW:VTD:MRV:DE_
toegelatene	toelaten	WKW:VTD:VRB
toegemetene	toemeten	WKW:VTD:VRB
toegemetenen	toemeten	WKW:VTD:MRV:DE_
toegenepenen	toenijpen	WKW:VTD:MRV:DE_
toegenomene	toenemen	WKW:VTD:VRB
toegenomenen	toenemen	WKW:VTD:MRV:DE_
toegescheidene	toescheiden	WKW:VTD:VRB
toegescheidenen	toescheiden	WKW:VTD:MRV:DE_
toegeschovene	toeschuiven	WKW:VTD:VRB
toegeschrevene	toeschrijven	WKW:VTD:VRB
toegeslagene	toeslaan	WKW:VTD:VRB
toegesprokene	toespreken	WKW:VTD:VRB
toegestanen	toestaan	WKW:VTD:MRV:DE_
toegetredene	toetreden	WKW:VTD:VRB
toegevlogene	toevliegen	WKW:VTD:VRB
toegevlogenen	toevliegen	WKW:VTD:MRV:DE_
toegevouwene	toevouwen	WKW:VTD:VRB
toegevouwenen	toevouwen	WKW:VTD:MRV:DE_
toegevrorene	toevriezen	WKW:VTD:VRB
toegevrorenen	toevriezen	WKW:VTD:MRV:DE_
toegewezene	toewijzen	WKW:VTD:VRB
toegeworpene	toewerpen	WKW:VTD:VRB
toegeziene	toezien	WKW:VTD:VRB
toegezondene	toezenden	WKW:VTD:VRB
toegezongene	toezingen	WKW:VTD:VRB
trapgelopene	traplopen	WKW:VTD:VRB
trapgelopenen	traplopen	WKW:VTD:MRV:DE_
uiteengebarstene	uiteenbarsten	WKW:VTD:VRB
uiteengebarstenen	uiteenbarsten	WKW:VTD:MRV:DE_
uiteengedane	uiteendoen	WKW:VTD:VRB
uiteengedanen	uiteendoen	WKW:VTD:MRV:DE_
uiteengetrokkene	uiteentrekken	WKW:VTD:VRB
uiteengetrokkenen	uiteentrekken	WKW:VTD:MRV:DE_
uitgebodene	uitbieden	WKW:VTD:VRB
uitgebodenen	uitbieden	WKW:VTD:MRV:DE_
uitgedane	uitdoen	WKW:VTD:VRB
uitgedanen	uitdoen	WKW:VTD:MRV:DE_
uitgedolvene	uitdelven	WKW:VTD:VRB
uitgedolvenen	uitdelven	WKW:VTD:MRV:DE_
uitgedragene	uitdragen	WKW:VTD:VRB
uitgedrevene	uitdrijven	WKW:VTD:VRB
uitgegane	uitgaan	WKW:VTD:VRB
uitgeganen	uitgaan	WKW:VTD:MRV:DE_
uitgegevene	uitgeven	WKW:VTD:VRB
uitgegledene	uitglijden	WKW:VTD:VRB
uitgegravene	uitgraven	WKW:VTD:VRB
uitgegravenen	uitgraven	WKW:VTD:MRV:DE_
uitgehangenen	uithangen	WKW:VTD:MRV:DE_
uitgehesene	uithijsen	WKW:VTD:VRB
uitgehesenen	uithijsen	WKW:VTD:MRV:DE_
uitgehevene	uitheffen	WKW:VTD:VRB
uitgehoudene	uithouden	WKW:VTD:VRB
uitgehoudenen	uithouden	WKW:VTD:MRV:DE_
uitgeklommene	uitklimmen	WKW:VTD:VRB
uitgeklommenen	uitklimmen	WKW:VTD:MRV:DE_
uitgeklonkene	uitklinken	WKW:VTD:VRB
uitgeklonkenen	uitklinken	WKW:VTD:MRV:DE_
uitgekomene	uitkomen	WKW:VTD:VRB
uitgekozene	uitkiezen	WKW:VTD:VRB
uitgelachene	uitlachen	WKW:VTD:VRB
uitgelatene	uitlaten	WKW:VTD:VRB
uitgelezene	uitlezen	WKW:VTD:VRB
uitgemetene	uitmeten	WKW:VTD:VRB
uitgemolkene	uitmelken	WKW:VTD:VRB
uitgemolkenen	uitmelken	WKW:VTD:MRV:DE_
uitgeredene	uitrijden	WKW:VTD:VRB
uitgeredenen	uitrijden	WKW:VTD:MRV:DE_
uitgeroepene	uitroepen	WKW:VTD:VRB
uitgeschedenen	uitscheiden	WKW:VTD:MRV:DE_
uitgeschetene	uitschijten	WKW:VTD:VRB
uitgeschetenen	uitschijten	WKW:VTD:MRV:DE_
uitgescholdene	uitschelden	WKW:VTD:VRB
uitgescholdenen	uitschelden	WKW:VTD:MRV:DE_
uitgeschrevene	uitschrijven	WKW:VTD:VRB
uitgeschrevenen	uitschrijven	WKW:VTD:MRV:DE_
uitgeslagene	uitslaan	WKW:VTD:VRB
uitgeslagenen	uitslaan	WKW:VTD:MRV:DE_
uitgeslapene	uitslapen	WKW:VTD:VRB
uitgeslapenen	uitslapen	WKW:VTD:MRV:DE_
uitgeslopene	uitsluipen	WKW:VTD:VRB
uitgeslopenen	uitsluipen	WKW:VTD:MRV:DE_
uitgeslotene	uitsluiten	WKW:VTD:VRB
uitgesmetene	uitsmijten	WKW:VTD:VRB
uitgesmetenen	uitsmijten	WKW:VTD:MRV:DE_
uitgespogene	uitspugen	WKW:VTD:VRB
uitgespogenen	uitspugen	WKW:VTD:MRV:DE_
uitgesponnene	uitspinnen	WKW:VTD:VRB
uitgesprokene	uitspreken	WKW:VTD:EKV
uitgesprokenen	uitspreken	WKW:VTD:MRV:DE_
uitgesprotene	uitspruiten	WKW:VTD:VRB
uitgesprotenen	uitspruiten	WKW:VTD:MRV:DE_
uitgestane	uitstaan	WKW:VTD:VRB
uitgestanen	uitstaan	WKW:VTD:MRV:DE_
uitgestegene	uitstijgen	WKW:VTD:VRB
uitgestegenen	uitstijgen	WKW:VTD:MRV:DE_
uitgestokene	uitsteken	WKW:VTD:VRB
uitgestorvene	uitsterven	WKW:VTD:VRB
uitgestotene	uitstoten	WKW:VTD:VRB
uitgestotenen	uitstoten	WKW:VTD:MRV:DE_
uitgestovene	uitstuiven	WKW:VTD:VRB
uitgestovenen	uitstuiven	WKW:VTD:MRV:DE_
uitgetredene	uittreden	WKW:VTD:VRB
uitgetrokkene	uittrekken	WKW:VTD:VRB
uitgevallene	uitvallen	WKW:VTD:VRB
uitgevallenen	uitvallen	WKW:VTD:MRV:DE_
uitgevondene	uitvinden	WKW:VTD:VRB
uitgevondenen	uitvinden	WKW:VTD:MRV:DE_
uitgevouwene	uitvouwen	WKW:VTD:VRB
uitgewassene	uitwassen	WKW:VTD:VRB
uitgewassenen	uitwassen	WKW:VTD:MRV:DE_
uitgewekene	uitwijken	WKW:VTD:VRB
uitgewezene	uitwijzen	WKW:VTD:VRB
uitgewogene	uitwegen	WKW:VTD:VRB
uitgewogenen	uitwegen	WKW:VTD:MRV:DE_
uitgeworpene	uitwerpen	WKW:VTD:VRB
uitgezogene	uitzuigen	WKW:VTD:VRB
uitgezondene	uitzenden	WKW:VTD:VRB
uitgezwommene	uitzwemmen	WKW:VTD:VRB
uitgezwommenen	uitzwemmen	WKW:VTD:MRV:DE_
uitgezworvene	uitzwerven	WKW:VTD:VRB
uitgezworvenen	uitzwerven	WKW:VTD:MRV:DE_
uitverkozene	uitverkiezen	WKW:VTD:VRB
vastgebakkene	vastbakken	WKW:VTD:VRB
vastgebakkenen	vastbakken	WKW:VTD:MRV:DE_
vastgehoudene	vasthouden	WKW:VTD:VRB
vastgeklonkene	vastklinken	WKW:VTD:VRB
vastgeklonkenen	vastklinken	WKW:VTD:MRV:DE_
vastgekregene	vastkrijgen	WKW:VTD:VRB
vastgelopene	vastlopen	WKW:VTD:VRB
vastgesmoltene	vastsmelten	WKW:VTD:VRB
vastgesmoltenen	vastsmelten	WKW:VTD:MRV:DE_
vastgestane	vaststaan	WKW:VTD:VRB
vastgestanen	vaststaan	WKW:VTD:MRV:DE_
vastgetrokkene	vasttrekken	WKW:VTD:VRB
vastgetrokkenen	vasttrekken	WKW:VTD:MRV:DE_
vastgevarene	vastvaren	WKW:VTD:VRB
vastgevarenen	vastvaren	WKW:VTD:MRV:DE_
vastgevezene	vastvijzen	WKW:VTD:VRB
vastgevezenen	vastvijzen	WKW:VTD:MRV:DE_
verbannene	verbannen	WKW:VTD:VRB
verbetene	verbijten	WKW:VTD:VRB
verblevene	verblijven	WKW:VTD:VRB
verbodene	verbieden	WKW:VTD:VRB
verbogene	verbuigen	WKW:VTD:VRB
verbondene	verbinden	WKW:VTD:VRB
verborgene	verbergen	WKW:VTD:VRB
verborgenen	verbergen	WKW:VTD:MRV:DE_
verbrokene	verbreken	WKW:VTD:VRB
verdorvene	verderven	WKW:VTD:VRB
verdrevene	verdrijven	WKW:VTD:VRB
verdrongene	verdringen	WKW:VTD:VRB
verdronkene	verdrinken	WKW:VTD:VRB
verdwenene	verdwijnen	WKW:VTD:VRB
vergelekene	vergelijken	WKW:VTD:VRB
vergetene	vergeten	WKW:VTD:VRB
vergevene	vergeven	WKW:VTD:VRB
vergevenen	vergeven	WKW:VTD:MRV:DE_
vergledene	verglijden	WKW:VTD:VRB
verhangene	verhangen	WKW:VTD:VRB
verhangenen	verhangen	WKW:VTD:MRV:DE_
verhevene	verheffen	WKW:VTD:VRB
verhevenen	verheffen	WKW:VTD:MRV:DE_
verkozene	verkiezen	WKW:VTD:VRB
verkregene	verkrijgen	WKW:VTD:VRB
verlatene	verlaten	WKW:VTD:VRB
verlegene	verliggen	WKW:VTD:VRB
verlopene	verlopen	WKW:VTD:VRB
verlorene	verliezen	WKW:VTD:VRB
vermedene	vermijden	WKW:VTD:VRB
vermogene	vermogen	WKW:VTD:VRB
vermogenen	vermogen	WKW:VTD:MRV:DE_
vernomene	vernemen	WKW:VTD:VRB
verradene	verraden	WKW:VTD:VRB
verrezene	verrijzen	WKW:VTD:VRB
verscheidene	verscheiden	WKW:VTD:EKV
verschenene	verschijnen	WKW:VTD:VRB
verscholene	verschuilen	WKW:VTD:VRB
verscholenen	verschuilen	WKW:VTD:MRV:DE_
verschotene	verschieten	WKW:VTD:VRB
verschrokkene	verschrikken	WKW:VTD:VRB
verschrokkenen	verschrikken	WKW:VTD:MRV:DE_
verslagene	verslaan	WKW:VTD:EKV
versletene	verslijten	WKW:VTD:VRB
verslondene	verslinden	WKW:VTD:VRB
verslondenen	verslinden	WKW:VTD:MRV:DE_
verstanen	verstaan	WKW:VTD:MRV:DE_
verstokene	versteken	WKW:VTD:EKV
verstokenen	versteken	WKW:VTD:MRV:DE_
verstorvene	versterven	WKW:VTD:VRB
verstorvenen	versterven	WKW:VTD:MRV:DE_
verstotene	verstoten	WKW:VTD:VRB
vertredene	vertreden	WKW:VTD:VRB
vertredenen	vertreden	WKW:VTD:MRV:DE_
vertrokkene	vertrekken	WKW:VTD:VRB
vervallene	vervallen	WKW:VTD:VRB
vervangene	vervangen	WKW:VTD:VRB
vervlogene	vervliegen	WKW:VTD:VRB
verwetene	verwijten	WKW:VTD:VRB
verwezene	verwijzen	WKW:VTD:VRB
verwonnene	verwinnen	WKW:VTD:VRB
verwonnenen	verwinnen	WKW:VTD:MRV:DE_
verwordenen	verworden	WKW:VTD:MRV:DE_
verworvene	verwerven	WKW:VTD:VRB
verworvenen	verwerven	WKW:VTD:MRV:DE_
verwrongene	verwringen	WKW:VTD:VRB
verzondene	verzenden	WKW:VTD:VRB
verzondenen	verzenden	WKW:VTD:MRV:DE_
verzonnene	verzinnen	WKW:VTD:VRB
verzonnenen	verzinnen	WKW:VTD:MRV:DE_
verzopene	verzuipen	WKW:VTD:VRB
verzwegene	verzwijgen	WKW:VTD:VRB
verzwolgene	verzwelgen	WKW:VTD:VRB
verzwolgenen	verzwelgen	WKW:VTD:MRV:DE_
verzwondene	verzwinden	WKW:VTD:VRB
vlakgestrekene	vlakstrijken	WKW:VTD:VRB
vlakgestrekenen	vlakstrijken	WKW:VTD:MRV:DE_
voldane	voldoen	WKW:VTD:VRB
voldanen	voldoen	WKW:VTD:MRV:DE_
volgedane	voldoen	WKW:VTD:VRB
volgedanen	voldoen	WKW:VTD:MRV:DE_
volgehoudene	volhouden	WKW:VTD:VRB
volgeladene	volladen	WKW:VTD:VRB
volgeladenen	volladen	WKW:VTD:MRV:DE_
volgeschetene	volschijten	WKW:VTD:VRB
volgeschetenen	volschijten	WKW:VTD:MRV:DE_
volgescholdene	volschelden	WKW:VTD:VRB
volgescholdenen	volschelden	WKW:VTD:MRV:DE_
volgestane	volstaan	WKW:VTD:VRB
volgestanen	volstaan	WKW:VTD:MRV:DE_
volgevretene	volvreten	WKW:VTD:VRB
voltrokkene	voltrekken	WKW:VTD:VRB
voltrokkenen	voltrekken	WKW:VTD:MRV:DE_
voorafgegane	voorafgaan	WKW:VTD:VRB
voorafgeganen	voorafgaan	WKW:VTD:MRV:DE_
voorbehoudene	voorbehouden	WKW:VTD:VRB
voorbesprokene	voorbespreken	WKW:VTD:VRB
voorbesprokenen	voorbespreken	WKW:VTD:MRV:DE_
voorbijgegane	voorbijgaan	WKW:VTD:VRB
voorbijgeganen	voorbijgaan	WKW:VTD:MRV:DE_
voorbijgegledene	voorbijglijden	WKW:VTD:VRB
voorbijgekropene	voorbijkruipen	WKW:VTD:VRB
voorbijgekropenen	voorbijkruipen	WKW:VTD:MRV:DE_
voorbijgestokene	voorbijsteken	WKW:VTD:VRB
voorbijgestovene	voorbijstuiven	WKW:VTD:VRB
voorbijgestovenen	voorbijstuiven	WKW:VTD:MRV:DE_
voorbijgevlogene	voorbijvliegen	WKW:VTD:VRB
voorgebakkene	voorbakken	WKW:VTD:VRB
voorgebakkenen	voorbakken	WKW:VTD:MRV:DE_
voorgebogene	voorbuigen	WKW:VTD:VRB
voorgebogenen	voorbuigen	WKW:VTD:MRV:DE_
voorgedane	voordoen	WKW:VTD:VRB
voorgedanen	voordoen	WKW:VTD:MRV:DE_
voorgedragene	voordragen	WKW:VTD:VRB
voorgedragenen	voordragen	WKW:VTD:MRV:DE_
voorgegane	voorgaan	WKW:VTD:VRB
voorgeganen	voorgaan	WKW:VTD:MRV:DE_
voorgegevene	voorgeven	WKW:VTD:VRB
voorgehangene	voorhangen	WKW:VTD:VRB
voorgehoudene	voorhouden	WKW:VTD:VRB
voorgehoudenen	voorhouden	WKW:VTD:MRV:DE_
voorgekozene	voorkiezen	WKW:VTD:VRB
voorgekrompene	voorkrimpen	WKW:VTD:VRB
voorgekrompenen	voorkrimpen	WKW:VTD:MRV:DE_
voorgelezene	voorlezen	WKW:VTD:VRB
voorgenomene	voornemen	WKW:VTD:VRB
voorgenomenen	voornemen	WKW:VTD:MRV:DE_
voorgeschotene	voorschieten	WKW:VTD:VRB
voorgeschovene	voorschuiven	WKW:VTD:VRB
voorgeschovenen	voorschuiven	WKW:VTD:MRV:DE_
voorgeschrevene	voorschrijven	WKW:VTD:VRB
voorgeschrevenen	voorschrijven	WKW:VTD:MRV:DE_
voorgeslapene	voorslapen	WKW:VTD:VRB
voorgespannene	voorspannen	WKW:VTD:VRB
voorgespannenen	voorspannen	WKW:VTD:MRV:DE_
voorgesprokene	voorspreken	WKW:VTD:VRB
voorgestane	voorstaan	WKW:VTD:VRB
voorgestanen	voorstaan	WKW:VTD:MRV:DE_
voorgestokene	voorsteken	WKW:VTD:VRB
voorgestokenen	voorsteken	WKW:VTD:MRV:DE_
voorgestrekene	voorstrijken	WKW:VTD:VRB
voorgestrekenen	voorstrijken	WKW:VTD:MRV:DE_
voorgetredene	voortreden	WKW:VTD:VRB
voorgetredenen	voortreden	WKW:VTD:MRV:DE_
voorgevallene	voorvallen	WKW:VTD:VRB
voorgevallenen	voorvallen	WKW:VTD:MRV:DE_
voorgewassene	voorwassen	WKW:VTD:VRB
voorgewassenen	voorwassen	WKW:VTD:MRV:DE_
voorgeworpene	voorwerpen	WKW:VTD:VRB
voorgeworpenen	voorwerpen	WKW:VTD:MRV:DE_
voorkomene	voorkomen	WKW:VTD:VRB
voorkomenen	voorkomen	WKW:VTD:MRV:DE_
vooropgelopene	vooroplopen	WKW:VTD:VRB
vooropgelopenen	vooroplopen	WKW:VTD:MRV:DE_
vooropgestane	vooropstaan	WKW:VTD:VRB
vooropgestanen	vooropstaan	WKW:VTD:MRV:DE_
voorovergebogene	vooroverbuigen	WKW:VTD:VRB
voorovergebogenen	vooroverbuigen	WKW:VTD:MRV:DE_
voortgedane	voortdoen	WKW:VTD:VRB
voortgedanen	voortdoen	WKW:VTD:MRV:DE_
voortgedrevene	voortdrijven	WKW:VTD:VRB
voortgegane	voortgaan	WKW:VTD:VRB
voortgeganen	voortgaan	WKW:VTD:MRV:DE_
voortgegledene	voortglijden	WKW:VTD:VRB
vooruitgegane	vooruitgaan	WKW:VTD:VRB
vooruitgeganen	vooruitgaan	WKW:VTD:MRV:DE_
vooruitgelopene	vooruitlopen	WKW:VTD:VRB
vooruitgeschovene	vooruitschuiven	WKW:VTD:VRB
vooruitgeschovenen	vooruitschuiven	WKW:VTD:MRV:DE_
vooruitgestokene	vooruitsteken	WKW:VTD:VRB
vooruitgewezene	vooruitwijzen	WKW:VTD:VRB
vooruitgewezenen	vooruitwijzen	WKW:VTD:MRV:DE_
vooruitgeziene	vooruitzien	WKW:VTD:VRB
voorziene	voorzien	WKW:VTD:VRB
voorzienen	voorzien	WKW:VTD:MRV:DE_
vormgegevenen	vormgeven	WKW:VTD:MRV:DE_
vreemdgegane	vreemdgaan	WKW:VTD:VRB
vreemdgeganen	vreemdgaan	WKW:VTD:MRV:DE_
vrijgehoudene	vrijhouden	WKW:VTD:VRB
vrijgelatene	vrijlaten	WKW:VTD:VRB
vrijgelatenen	vrijlaten	WKW:VTD:MRV:DE_
vrijgelopene	vrijlopen	WKW:VTD:VRB
vrijgelopenen	vrijlopen	WKW:VTD:MRV:DE_
vrijgesprokene	vrijspreken	WKW:VTD:VRB
vrijgesprokenen	vrijspreken	WKW:VTD:MRV:DE_
vrijgestane	vrijstaan	WKW:VTD:VRB
vrijgestanen	vrijstaan	WKW:VTD:MRV:DE_
vrijgevallene	vrijvallen	WKW:VTD:VRB
vrijgevochtenen	vrijvechten	WKW:VTD:MRV:DE_
vrijgezwommenen	vrijgezwommenen	WKW:VTD:MRV:DE_
vroeggestorvenen	vroeggestorvenen	WKW:VTD:MRV:DE_
waargenomene	waarnemen	WKW:VTD:VRB
wachtgelopene	wachtlopen	WKW:VTD:VRB
wachtgelopenen	wachtlopen	WKW:VTD:MRV:DE_
warmgehoudene	warmhouden	WKW:VTD:VRB
warmgeredene	warmrijden	WKW:VTD:VRB
warmgeredenen	warmrijden	WKW:VTD:MRV:DE_
wedergegevene	wedergeven	WKW:VTD:VRB
wedergegevenen	wedergeven	WKW:VTD:MRV:DE_
wedergekomene	wederkomen	WKW:VTD:VRB
wedergeziene	wederzien	WKW:VTD:VRB
wedergezienen	wederzien	WKW:VTD:MRV:DE_
wedervarene	wedervaren	WKW:VTD:VRB
wedervarenen	wedervaren	WKW:VTD:MRV:DE_
weergegevene	weergeven	WKW:VTD:VRB
weeromgekomene	weeromkomen	WKW:VTD:VRB
weeromgekomenen	weeromkomen	WKW:VTD:MRV:DE_
weggebetene	wegbijten	WKW:VTD:VRB
weggebogene	wegbuigen	WKW:VTD:VRB
weggebogenen	wegbuigen	WKW:VTD:MRV:DE_
weggeborgene	wegbergen	WKW:VTD:VRB
weggeborgenen	wegbergen	WKW:VTD:MRV:DE_
weggedane	wegdoen	WKW:VTD:VRB
weggedanen	wegdoen	WKW:VTD:MRV:DE_
weggedokene	wegduiken	WKW:VTD:VRB
weggedrevene	wegdrijven	WKW:VTD:VRB
weggeflotene	wegfluiten	WKW:VTD:VRB
weggeflotenen	wegfluiten	WKW:VTD:MRV:DE_
weggegane	weggaan	WKW:VTD:VRB
weggeganen	weggaan	WKW:VTD:MRV:DE_
weggegetene	wegeten	WKW:VTD:VRB
weggegledene	wegglijden	WKW:VTD:VRB
weggegravene	weggraven	WKW:VTD:VRB
weggegravenen	weggraven	WKW:VTD:MRV:DE_
weggehangene	weghangen	WKW:VTD:VRB
weggelatene	weglaten	WKW:VTD:VRB
weggemalene	wegmalen	WKW:VTD:VRB
weggenomene	wegnemen	WKW:VTD:VRB
weggeredene	wegrijden	WKW:VTD:VRB
weggeredenen	wegrijden	WKW:VTD:MRV:DE_
weggeroepene	wegroepen	WKW:VTD:VRB
weggeschotenen	wegschieten	WKW:VTD:MRV:DE_
weggeslepene	wegslijpen	WKW:VTD:VRB
weggeslopene	wegsluipen	WKW:VTD:VRB
weggeslopenen	wegsluipen	WKW:VTD:MRV:DE_
weggesmetenen	wegsmijten	WKW:VTD:MRV:DE_
weggesnedene	wegsnijden	WKW:VTD:VRB
weggespotene	wegspuiten	WKW:VTD:VRB
weggespotenen	wegspuiten	WKW:VTD:MRV:DE_
weggestokene	wegsteken	WKW:VTD:VRB
weggestorvene	weggestorvene	WKW:VTD:VRB
weggestotene	wegstoten	WKW:VTD:VRB
weggestrekene	wegstrijken	WKW:VTD:VRB
weggestrekenen	wegstrijken	WKW:VTD:MRV:DE_
weggevallene	wegvallen	WKW:VTD:VRB
weggevouwene	wegvouwen	WKW:VTD:VRB
weggevouwenen	wegvouwen	WKW:VTD:MRV:DE_
weggewassene	wegwassen	WKW:VTD:VRB
weggewassenen	wegwassen	WKW:VTD:MRV:DE_
weggeworpene	wegwerpen	WKW:VTD:VRB
weggewrevene	wegwrijven	WKW:VTD:VRB
weggewrevenen	wegwrijven	WKW:VTD:MRV:DE_
weggezondene	wegzenden	WKW:VTD:VRB
weggezongene	wegzingen	WKW:VTD:VRB
weggezongenen	wegzingen	WKW:VTD:MRV:DE_
welgedanen	weldoen	WKW:VTD:MRV:DE_
welgegane	welgaan	WKW:VTD:VRB
welgeganen	welgaan	WKW:VTD:MRV:DE_
welgevarene	welvaren	WKW:VTD:VRB
welgevarenen	welvaren	WKW:VTD:MRV:DE_
zwartgekekene	zwartkijken	WKW:VTD:VRB
zwartgekekenen	zwartkijken	WKW:VTD:MRV:DE_
zwartgeredene	zwartrijden	WKW:VTD:VRB
zwartgeredenen	zwartrijden	WKW:VTD:MRV:DE_
grinten	grinten	UNSPECIFIED
niet	niet	SPC:NOT
